Commit_ID,Commit_Author_Login,File_Name,Additions,Changes,Deletions
2457bf1d53b0e91aa69c644fce6af71b87fb78c3,codal-sid,frontend/src/App.js,2,2,0
2457bf1d53b0e91aa69c644fce6af71b87fb78c3,codal-sid,frontend/src/Pages/Projects/AddProject/Component/addProject.jsx,8,14,6
2457bf1d53b0e91aa69c644fce6af71b87fb78c3,codal-sid,frontend/src/Pages/Projects/ProjectDetails/Component/project.jsx,8,9,1
2457bf1d53b0e91aa69c644fce6af71b87fb78c3,codal-sid,frontend/src/Pages/Request/RequestList/Component/request.jsx,24,28,4
2457bf1d53b0e91aa69c644fce6af71b87fb78c3,codal-sid,frontend/src/common/Config.js,1,2,1
955e3d035a0a712c7dd8dcd5273d4df97ea7bd2f,codal-jsojitra,frontend/src/Pages/Projects/AddProject/Component/addProject.jsx,7,13,6
955e3d035a0a712c7dd8dcd5273d4df97ea7bd2f,codal-jsojitra,frontend/src/Pages/Projects/ProjectDetails/Component/project.jsx,8,9,1
27dd33af5e3662ea8fe04522fdd363a517298738,codal-jsojitra,frontend/src/Pages/Projects/AddProject/Component/addProject.jsx,2,3,1
541e7ee2eae7c96114cf85fdfa461a82ae4a2a60,codal-sid,backend/mainapp/celery_app.py,4,4,0
541e7ee2eae7c96114cf85fdfa461a82ae4a2a60,codal-sid,backend/mainapp/settings.py,2,2,0
541e7ee2eae7c96114cf85fdfa461a82ae4a2a60,codal-sid,backend/requirements.txt,1,1,0
541e7ee2eae7c96114cf85fdfa461a82ae4a2a60,codal-sid,backend/rptool/admin.py,1,2,1
541e7ee2eae7c96114cf85fdfa461a82ae4a2a60,codal-sid,backend/rptool/migrations/0041_employee_slack_id.py,18,18,0
541e7ee2eae7c96114cf85fdfa461a82ae4a2a60,codal-sid,backend/rptool/models.py,1,1,0
541e7ee2eae7c96114cf85fdfa461a82ae4a2a60,codal-sid,backend/rptool/signals.py,48,49,1
541e7ee2eae7c96114cf85fdfa461a82ae4a2a60,codal-sid,backend/rptool/tasks.py,152,154,2
b21785d4b33553523807c4e49f07658157e0a301,pkiri-codal,backend/django.db,0,0,0
a784082ffd5f2cf3152513e7a22b4ab4ac5c56a5,pkiri-codal,backend/rptool/tasks.py,2,7,5
b946c55962967b1d42e6e5fd5c4d550f2ac1c7b2,pkiri-codal,backend/django.db,0,0,0
b946c55962967b1d42e6e5fd5c4d550f2ac1c7b2,pkiri-codal,backend/mainapp/celery_app.py,4,4,0
b946c55962967b1d42e6e5fd5c4d550f2ac1c7b2,pkiri-codal,backend/rptool/signals.py,4,6,2
b946c55962967b1d42e6e5fd5c4d550f2ac1c7b2,pkiri-codal,backend/rptool/tasks.py,91,143,52
d70070d8fc0e0acf6a1d24061a35ea3da6eb59f3,pkiri-codal,backend/rptool/signals.py,1,2,1
20c1c809ababff0877708513dd5bbe3f25031b2e,pkiri-codal,backend/rptool/signals.py,15,132,117
20c1c809ababff0877708513dd5bbe3f25031b2e,pkiri-codal,backend/rptool/tasks.py,114,115,1
8e165c446b30fee38fa68db452a7ecf73adc43cb,pkiri-codal,backend/rptool/signals.py,4,8,4
fdb294648af03fd66c10bf7b962993127b43ddc6,codal-jsojitra,frontend/src/App.js,2,2,0
fdb294648af03fd66c10bf7b962993127b43ddc6,codal-jsojitra,frontend/src/Pages/Request/RequestList/Component/request.jsx,24,28,4
fdb294648af03fd66c10bf7b962993127b43ddc6,codal-jsojitra,frontend/src/common/Config.js,1,2,1
dbfa817cd22bc3fd7c3754593f12552c11be7e22,pkiri-codal,backend/mainapp/settings.py,0,1,1
84a7690dd74f0c2782c51811d72d263db50d0f62,pkiri-codal,backend/rptool/signals.py,13,19,6
2d8f42918254cd62b51c46e8d0a0de312bf89707,pkiri-codal,backend/rptool/signals.py,4,8,4
d079794fdfaca5671315d38c86c9b11c1fe1df0f,pkiri-codal,backend/rptool/signals.py,3,6,3
11eb1e336fea333aeb2372bb31910863ccf27ac7,pkiri-codal,backend/rptool/signals.py,84,181,97
b5afc23abd2096d6c16e857019b82493e3a0733b,pkiri-codal,backend/rptool/signals.py,32,34,2
14846559d37566031447b2e8e8a7e28910c66ef1,pkiri-codal,backend/rptool/signals.py,93,105,12
a83f4135640b87b09661e246ed66fd4672c2af1d,pkiri-codal,backend/rptool/signals.py,21,27,6
dc6255519dcb841683d5fa3d738f547d49bcdab9,pkiri-codal,backend/rptool/signals.py,22,22,0
6f3c0b42db995273aa13c6df1d8470fe2eb0c67b,pkiri-codal,backend/requirements.txt,1,2,1
6f3c0b42db995273aa13c6df1d8470fe2eb0c67b,pkiri-codal,backend/rptool/signals.py,5,5,0
8ab4099d48f2c0d2f08b45a986b10ef9bee7a274,pkiri-codal,backend/rptool/admin.py,1,2,1
8ab4099d48f2c0d2f08b45a986b10ef9bee7a274,pkiri-codal,backend/rptool/tasks.py,2,3,1
e577610883abddc3b6f8d0caf9728893c2a64335,pkiri-codal,backend/mainapp/settings.py,3,3,0
e577610883abddc3b6f8d0caf9728893c2a64335,pkiri-codal,backend/requirements.txt,0,1,1
e577610883abddc3b6f8d0caf9728893c2a64335,pkiri-codal,backend/rptool/migrations/0041_employee_slack_id.py,18,18,0
e577610883abddc3b6f8d0caf9728893c2a64335,pkiri-codal,backend/rptool/models.py,1,1,0
a58cf729bc0f6cf76cee5d1b8f1a80b919e2f844,pkiri-codal,frontend/src/Actions/index.js,43,287,244
a58cf729bc0f6cf76cee5d1b8f1a80b919e2f844,pkiri-codal,frontend/src/App.js,4,8,4
a58cf729bc0f6cf76cee5d1b8f1a80b919e2f844,pkiri-codal,frontend/src/Assets/Json/DataTable.js,18,28,10
a58cf729bc0f6cf76cee5d1b8f1a80b919e2f844,pkiri-codal,frontend/src/Assets/css/scss/style.scss,0,4,4
a58cf729bc0f6cf76cee5d1b8f1a80b919e2f844,pkiri-codal,frontend/src/Pages/Auth/Component/login.jsx,34,49,15
a58cf729bc0f6cf76cee5d1b8f1a80b919e2f844,pkiri-codal,frontend/src/Pages/Common/Component/Header.jsx,15,22,7
a58cf729bc0f6cf76cee5d1b8f1a80b919e2f844,pkiri-codal,frontend/src/Pages/Organization/Component/Organization.jsx,5,8,3
a58cf729bc0f6cf76cee5d1b8f1a80b919e2f844,pkiri-codal,frontend/src/Pages/People/Component/employee.jsx,39,62,23
a58cf729bc0f6cf76cee5d1b8f1a80b919e2f844,pkiri-codal,frontend/src/Pages/People/Component/people.jsx,1,1,0
a58cf729bc0f6cf76cee5d1b8f1a80b919e2f844,pkiri-codal,frontend/src/Pages/People/Component/upcoming.jsx,21,34,13
a58cf729bc0f6cf76cee5d1b8f1a80b919e2f844,pkiri-codal,frontend/src/Pages/Projects/AddProject/Component/addProject.jsx,18,40,22
a58cf729bc0f6cf76cee5d1b8f1a80b919e2f844,pkiri-codal,frontend/src/Pages/Projects/EditProject/Component/EditProject.js,13,30,17
a58cf729bc0f6cf76cee5d1b8f1a80b919e2f844,pkiri-codal,frontend/src/Pages/Projects/ProjectDetails/Component/project.jsx,48,94,46
a58cf729bc0f6cf76cee5d1b8f1a80b919e2f844,pkiri-codal,frontend/src/Pages/Projects/ProjectList/Component/projectList.jsx,15,21,6
a58cf729bc0f6cf76cee5d1b8f1a80b919e2f844,pkiri-codal,frontend/src/Pages/Request/EditChangeAllocation/Component/EditAllocation.jsx,19,31,12
a58cf729bc0f6cf76cee5d1b8f1a80b919e2f844,pkiri-codal,frontend/src/Pages/Request/EditMoveAllocation/Component/EditMoveResource.jsx,19,31,12
a58cf729bc0f6cf76cee5d1b8f1a80b919e2f844,pkiri-codal,frontend/src/Pages/Request/EditRequest/Component/EditResource.jsx,17,35,18
a58cf729bc0f6cf76cee5d1b8f1a80b919e2f844,pkiri-codal,frontend/src/Pages/Request/RequestList/Component/request.jsx,43,71,28
a58cf729bc0f6cf76cee5d1b8f1a80b919e2f844,pkiri-codal,frontend/src/Pages/Request/RequestResource/Component/AddRequest/AddRequest.jsx,14,37,23
a58cf729bc0f6cf76cee5d1b8f1a80b919e2f844,pkiri-codal,frontend/src/Pages/Request/RequestResource/Component/EditResource/Component/EditRequest.jsx,24,40,16
a58cf729bc0f6cf76cee5d1b8f1a80b919e2f844,pkiri-codal,frontend/src/Pages/Request/RequestResource/Component/MoveResourceStep/Component/MoveResource.jsx,1,1,0
a58cf729bc0f6cf76cee5d1b8f1a80b919e2f844,pkiri-codal,frontend/src/Pages/Request/RequestResource/Component/MoveResourceStep/Component/Step1.jsx,4,5,1
a58cf729bc0f6cf76cee5d1b8f1a80b919e2f844,pkiri-codal,frontend/src/Pages/Request/RequestResource/Component/MoveResourceStep/Component/Step2.jsx,4,5,1
a58cf729bc0f6cf76cee5d1b8f1a80b919e2f844,pkiri-codal,frontend/src/Pages/Request/RequestResource/Component/RequestSubmit.jsx,1,1,0
a58cf729bc0f6cf76cee5d1b8f1a80b919e2f844,pkiri-codal,frontend/src/Pages/Typo/typo.js,1,1,0
a58cf729bc0f6cf76cee5d1b8f1a80b919e2f844,pkiri-codal,frontend/src/Pages/UserProfile/Edit/Component/EditProfile.jsx,13,27,14
a58cf729bc0f6cf76cee5d1b8f1a80b919e2f844,pkiri-codal,frontend/src/Pages/UserProfile/Profile/Component/profile.jsx,51,104,53
a58cf729bc0f6cf76cee5d1b8f1a80b919e2f844,pkiri-codal,frontend/src/Reducers/Project/GetJiraAccounts.js,1,2,1
a58cf729bc0f6cf76cee5d1b8f1a80b919e2f844,pkiri-codal,frontend/src/Reducers/User/GetUserTimeLog.js,1,2,1
a58cf729bc0f6cf76cee5d1b8f1a80b919e2f844,pkiri-codal,frontend/src/common/Redirection.js,18,18,0
a58cf729bc0f6cf76cee5d1b8f1a80b919e2f844,pkiri-codal,frontend/src/common/RoleServices.js,2,2,0
58d5a88ee6211b62529c0dceb7a8c804bedcd821,codal-sid,frontend/src/Pages/Auth/Component/login.jsx,5,10,5
58d5a88ee6211b62529c0dceb7a8c804bedcd821,codal-sid,frontend/src/common/Redirection.js,0,1,1
58d5a88ee6211b62529c0dceb7a8c804bedcd821,codal-sid,frontend/src/common/RoleServices.js,5,9,4
50ab5ed876a376f65bf37bdbee8deb37f083f809,codal-jsojitra,frontend/src/Pages/Auth/Component/login.jsx,5,10,5
50ab5ed876a376f65bf37bdbee8deb37f083f809,codal-jsojitra,frontend/src/common/Redirection.js,0,1,1
50ab5ed876a376f65bf37bdbee8deb37f083f809,codal-jsojitra,frontend/src/common/RoleServices.js,5,9,4
3b78c01aaf501cd33b029d52a4dff12766a948e1,codal-sid,frontend/src/Actions/index.js,43,287,244
3b78c01aaf501cd33b029d52a4dff12766a948e1,codal-sid,frontend/src/App.js,4,8,4
3b78c01aaf501cd33b029d52a4dff12766a948e1,codal-sid,frontend/src/Assets/Json/DataTable.js,18,28,10
3b78c01aaf501cd33b029d52a4dff12766a948e1,codal-sid,frontend/src/Assets/css/scss/style.scss,0,4,4
3b78c01aaf501cd33b029d52a4dff12766a948e1,codal-sid,frontend/src/Pages/Auth/Component/login.jsx,34,49,15
3b78c01aaf501cd33b029d52a4dff12766a948e1,codal-sid,frontend/src/Pages/Common/Component/Header.jsx,15,22,7
3b78c01aaf501cd33b029d52a4dff12766a948e1,codal-sid,frontend/src/Pages/Organization/Component/Organization.jsx,5,8,3
3b78c01aaf501cd33b029d52a4dff12766a948e1,codal-sid,frontend/src/Pages/People/Component/employee.jsx,39,62,23
3b78c01aaf501cd33b029d52a4dff12766a948e1,codal-sid,frontend/src/Pages/People/Component/people.jsx,1,1,0
3b78c01aaf501cd33b029d52a4dff12766a948e1,codal-sid,frontend/src/Pages/People/Component/upcoming.jsx,21,34,13
3b78c01aaf501cd33b029d52a4dff12766a948e1,codal-sid,frontend/src/Pages/Projects/AddProject/Component/addProject.jsx,18,40,22
3b78c01aaf501cd33b029d52a4dff12766a948e1,codal-sid,frontend/src/Pages/Projects/EditProject/Component/EditProject.js,13,30,17
3b78c01aaf501cd33b029d52a4dff12766a948e1,codal-sid,frontend/src/Pages/Projects/ProjectDetails/Component/project.jsx,48,94,46
3b78c01aaf501cd33b029d52a4dff12766a948e1,codal-sid,frontend/src/Pages/Projects/ProjectList/Component/projectList.jsx,15,21,6
3b78c01aaf501cd33b029d52a4dff12766a948e1,codal-sid,frontend/src/Pages/Request/EditChangeAllocation/Component/EditAllocation.jsx,19,31,12
3b78c01aaf501cd33b029d52a4dff12766a948e1,codal-sid,frontend/src/Pages/Request/EditMoveAllocation/Component/EditMoveResource.jsx,19,31,12
3b78c01aaf501cd33b029d52a4dff12766a948e1,codal-sid,frontend/src/Pages/Request/EditRequest/Component/EditResource.jsx,17,35,18
3b78c01aaf501cd33b029d52a4dff12766a948e1,codal-sid,frontend/src/Pages/Request/RequestList/Component/request.jsx,43,71,28
3b78c01aaf501cd33b029d52a4dff12766a948e1,codal-sid,frontend/src/Pages/Request/RequestResource/Component/AddRequest/AddRequest.jsx,14,37,23
3b78c01aaf501cd33b029d52a4dff12766a948e1,codal-sid,frontend/src/Pages/Request/RequestResource/Component/EditResource/Component/EditRequest.jsx,24,40,16
3b78c01aaf501cd33b029d52a4dff12766a948e1,codal-sid,frontend/src/Pages/Request/RequestResource/Component/MoveResourceStep/Component/MoveResource.jsx,1,1,0
3b78c01aaf501cd33b029d52a4dff12766a948e1,codal-sid,frontend/src/Pages/Request/RequestResource/Component/MoveResourceStep/Component/Step1.jsx,4,5,1
3b78c01aaf501cd33b029d52a4dff12766a948e1,codal-sid,frontend/src/Pages/Request/RequestResource/Component/MoveResourceStep/Component/Step2.jsx,4,5,1
3b78c01aaf501cd33b029d52a4dff12766a948e1,codal-sid,frontend/src/Pages/Request/RequestResource/Component/RequestSubmit.jsx,1,1,0
3b78c01aaf501cd33b029d52a4dff12766a948e1,codal-sid,frontend/src/Pages/Typo/typo.js,1,1,0
3b78c01aaf501cd33b029d52a4dff12766a948e1,codal-sid,frontend/src/Pages/UserProfile/Edit/Component/EditProfile.jsx,13,27,14
3b78c01aaf501cd33b029d52a4dff12766a948e1,codal-sid,frontend/src/Pages/UserProfile/Profile/Component/profile.jsx,51,104,53
3b78c01aaf501cd33b029d52a4dff12766a948e1,codal-sid,frontend/src/Reducers/Project/GetJiraAccounts.js,1,2,1
3b78c01aaf501cd33b029d52a4dff12766a948e1,codal-sid,frontend/src/Reducers/User/GetUserTimeLog.js,1,2,1
3b78c01aaf501cd33b029d52a4dff12766a948e1,codal-sid,frontend/src/common/Redirection.js,19,19,0
3b78c01aaf501cd33b029d52a4dff12766a948e1,codal-sid,frontend/src/common/RoleServices.js,5,9,4
14dab59cede13c20d0bb68b721071ac0105a6757,codal-jsojitra,frontend/src/Pages/Request/EditChangeAllocation/Component/EditAllocation.jsx,16,31,15
14dab59cede13c20d0bb68b721071ac0105a6757,codal-jsojitra,frontend/src/Pages/Request/EditMoveAllocation/Component/EditMoveResource.jsx,14,28,14
14dab59cede13c20d0bb68b721071ac0105a6757,codal-jsojitra,frontend/src/Pages/Request/EditRequest/Component/EditResource.jsx,17,36,19
14dab59cede13c20d0bb68b721071ac0105a6757,codal-jsojitra,frontend/src/Pages/Request/RequestList/Component/request.jsx,32,61,29
14dab59cede13c20d0bb68b721071ac0105a6757,codal-jsojitra,frontend/src/Pages/Request/RequestResource/Component/AddRequest/AddRequest.jsx,12,34,22
14dab59cede13c20d0bb68b721071ac0105a6757,codal-jsojitra,frontend/src/Pages/Request/RequestResource/Component/EditResource/Component/EditRequest.jsx,15,29,14
a7eabad61af4523f965bc5d0e2b843c5cdfafda6,codal-jsojitra,frontend/src/Pages/Projects/AddProject/Component/addProject.jsx,15,36,21
a7eabad61af4523f965bc5d0e2b843c5cdfafda6,codal-jsojitra,frontend/src/Pages/Projects/EditProject/Component/EditProject.js,7,16,9
a7eabad61af4523f965bc5d0e2b843c5cdfafda6,codal-jsojitra,frontend/src/Pages/Projects/ProjectDetails/Component/project.jsx,22,49,27
de7441a40f92a752322f0be7605ff83d3619bab4,codal-jsojitra,frontend/src/Pages/People/Component/employee.jsx,36,63,27
de7441a40f92a752322f0be7605ff83d3619bab4,codal-jsojitra,frontend/src/Pages/People/Component/people.jsx,1,2,1
de7441a40f92a752322f0be7605ff83d3619bab4,codal-jsojitra,frontend/src/Pages/People/Component/upcoming.jsx,21,40,19
c65c67a1297b8aa01a5c4c5c4f552f626467a243,codal-jsojitra,frontend/src/Pages/Organization/Component/Organization.jsx,4,8,4
c62f5ef30edfdf7048af8fbc4b78562afa42fc21,codal-jsojitra,frontend/src/Pages/Common/Component/Header.jsx,7,14,7
24f6d3a90a89b0f382c7ca9e6d7736ccafbe421f,codal-jsojitra,frontend/src/Pages/Auth/Component/login.jsx,8,19,11
49956f5df37ea20b8c330bc70bcc497932881eaf,codal-jsojitra,frontend/src/Assets/Json/DataTable.js,13,29,16
49956f5df37ea20b8c330bc70bcc497932881eaf,codal-jsojitra,frontend/src/Pages/Auth/Component/login.jsx,1,2,1
49956f5df37ea20b8c330bc70bcc497932881eaf,codal-jsojitra,frontend/src/Pages/UserProfile/Edit/Component/EditProfile.jsx,7,18,11
49956f5df37ea20b8c330bc70bcc497932881eaf,codal-jsojitra,frontend/src/Pages/UserProfile/Profile/Component/profile.jsx,38,73,35
ba0100879b8043346758bcaca6304be4008efce6,codal-jsojitra,frontend/src/Actions/index.js,43,285,242
ba0100879b8043346758bcaca6304be4008efce6,codal-jsojitra,frontend/src/Assets/Json/DataTable.js,1,1,0
ba0100879b8043346758bcaca6304be4008efce6,codal-jsojitra,frontend/src/Pages/Auth/Component/login.jsx,29,36,7
ba0100879b8043346758bcaca6304be4008efce6,codal-jsojitra,frontend/src/Pages/Common/Component/Header.jsx,1,1,0
ba0100879b8043346758bcaca6304be4008efce6,codal-jsojitra,frontend/src/Pages/Organization/Component/Organization.jsx,2,2,0
ba0100879b8043346758bcaca6304be4008efce6,codal-jsojitra,frontend/src/Pages/People/Component/employee.jsx,1,1,0
ba0100879b8043346758bcaca6304be4008efce6,codal-jsojitra,frontend/src/Pages/People/Component/people.jsx,1,1,0
ba0100879b8043346758bcaca6304be4008efce6,codal-jsojitra,frontend/src/Pages/People/Component/upcoming.jsx,1,1,0
ba0100879b8043346758bcaca6304be4008efce6,codal-jsojitra,frontend/src/Pages/Projects/AddProject/Component/addProject.jsx,1,1,0
ba0100879b8043346758bcaca6304be4008efce6,codal-jsojitra,frontend/src/Pages/Projects/EditProject/Component/EditProject.js,1,1,0
ba0100879b8043346758bcaca6304be4008efce6,codal-jsojitra,frontend/src/Pages/Projects/ProjectDetails/Component/project.jsx,1,1,0
ba0100879b8043346758bcaca6304be4008efce6,codal-jsojitra,frontend/src/Pages/Projects/ProjectList/Component/projectList.jsx,1,1,0
ba0100879b8043346758bcaca6304be4008efce6,codal-jsojitra,frontend/src/Pages/Request/EditChangeAllocation/Component/EditAllocation.jsx,1,1,0
ba0100879b8043346758bcaca6304be4008efce6,codal-jsojitra,frontend/src/Pages/Request/EditMoveAllocation/Component/EditMoveResource.jsx,1,1,0
ba0100879b8043346758bcaca6304be4008efce6,codal-jsojitra,frontend/src/Pages/Request/EditRequest/Component/EditResource.jsx,1,1,0
ba0100879b8043346758bcaca6304be4008efce6,codal-jsojitra,frontend/src/Pages/Request/RequestList/Component/request.jsx,1,2,1
ba0100879b8043346758bcaca6304be4008efce6,codal-jsojitra,frontend/src/Pages/Request/RequestResource/Component/AddRequest/AddRequest.jsx,1,1,0
ba0100879b8043346758bcaca6304be4008efce6,codal-jsojitra,frontend/src/Pages/Request/RequestResource/Component/EditResource/Component/EditRequest.jsx,1,1,0
ba0100879b8043346758bcaca6304be4008efce6,codal-jsojitra,frontend/src/Pages/Request/RequestResource/Component/MoveResourceStep/Component/MoveResource.jsx,1,1,0
ba0100879b8043346758bcaca6304be4008efce6,codal-jsojitra,frontend/src/Pages/Request/RequestResource/Component/MoveResourceStep/Component/Step1.jsx,1,1,0
ba0100879b8043346758bcaca6304be4008efce6,codal-jsojitra,frontend/src/Pages/Request/RequestResource/Component/MoveResourceStep/Component/Step2.jsx,1,1,0
ba0100879b8043346758bcaca6304be4008efce6,codal-jsojitra,frontend/src/Pages/Request/RequestResource/Component/RequestSubmit.jsx,1,1,0
ba0100879b8043346758bcaca6304be4008efce6,codal-jsojitra,frontend/src/Pages/Typo/typo.js,1,1,0
ba0100879b8043346758bcaca6304be4008efce6,codal-jsojitra,frontend/src/Pages/UserProfile/Edit/Component/EditProfile.jsx,1,1,0
ba0100879b8043346758bcaca6304be4008efce6,codal-jsojitra,frontend/src/Pages/UserProfile/Profile/Component/profile.jsx,1,1,0
ba0100879b8043346758bcaca6304be4008efce6,codal-jsojitra,frontend/src/Reducers/Project/GetJiraAccounts.js,1,2,1
ba0100879b8043346758bcaca6304be4008efce6,codal-jsojitra,frontend/src/Reducers/User/GetUserTimeLog.js,1,2,1
ba0100879b8043346758bcaca6304be4008efce6,codal-jsojitra,frontend/src/common/Redirection.js,19,19,0
ba0100879b8043346758bcaca6304be4008efce6,codal-jsojitra,frontend/src/common/RoleServices.js,5,9,4
cf8a8158818e1a426ebeed9a80bee72734d333ce,codal-jsojitra,frontend/src/App.js,2,4,2
cf8a8158818e1a426ebeed9a80bee72734d333ce,codal-jsojitra,frontend/src/Pages/Projects/EditProject/Component/EditProject.js,6,12,6
cf8a8158818e1a426ebeed9a80bee72734d333ce,codal-jsojitra,frontend/src/Pages/Projects/ProjectDetails/Component/project.jsx,32,60,28
cf8a8158818e1a426ebeed9a80bee72734d333ce,codal-jsojitra,frontend/src/Pages/Projects/ProjectList/Component/projectList.jsx,9,13,4
cf8a8158818e1a426ebeed9a80bee72734d333ce,codal-jsojitra,frontend/src/Pages/UserProfile/Profile/Component/profile.jsx,4,16,12
5bb7981be12d1f542b33fd8cbad62272774a82d8,codal-jsojitra,frontend/src/App.js,1,2,1
5bb7981be12d1f542b33fd8cbad62272774a82d8,codal-jsojitra,frontend/src/Pages/People/Component/employee.jsx,3,4,1
5bb7981be12d1f542b33fd8cbad62272774a82d8,codal-jsojitra,frontend/src/Pages/People/Component/upcoming.jsx,7,9,2
5bb7981be12d1f542b33fd8cbad62272774a82d8,codal-jsojitra,frontend/src/Pages/Request/EditChangeAllocation/Component/EditAllocation.jsx,8,11,3
5bb7981be12d1f542b33fd8cbad62272774a82d8,codal-jsojitra,frontend/src/Pages/Request/EditMoveAllocation/Component/EditMoveResource.jsx,9,12,3
5bb7981be12d1f542b33fd8cbad62272774a82d8,codal-jsojitra,frontend/src/Pages/Request/RequestList/Component/request.jsx,18,24,6
5bb7981be12d1f542b33fd8cbad62272774a82d8,codal-jsojitra,frontend/src/Pages/Request/RequestResource/Component/EditResource/Component/EditRequest.jsx,12,18,6
5bb7981be12d1f542b33fd8cbad62272774a82d8,codal-jsojitra,frontend/src/Pages/Request/RequestResource/Component/MoveResourceStep/Component/Step1.jsx,3,4,1
5bb7981be12d1f542b33fd8cbad62272774a82d8,codal-jsojitra,frontend/src/Pages/Request/RequestResource/Component/MoveResourceStep/Component/Step2.jsx,3,4,1
5bb7981be12d1f542b33fd8cbad62272774a82d8,codal-jsojitra,frontend/src/Pages/UserProfile/Edit/Component/EditProfile.jsx,8,13,5
5bb7981be12d1f542b33fd8cbad62272774a82d8,codal-jsojitra,frontend/src/Pages/UserProfile/Profile/Component/profile.jsx,5,7,2
844739634062501289fe020611d2bfb218f7087a,codal-jsojitra,frontend/src/App.js,1,2,1
844739634062501289fe020611d2bfb218f7087a,codal-jsojitra,frontend/src/Assets/Json/DataTable.js,12,14,2
844739634062501289fe020611d2bfb218f7087a,codal-jsojitra,frontend/src/Pages/Common/Component/Header.jsx,10,13,3
844739634062501289fe020611d2bfb218f7087a,codal-jsojitra,frontend/src/Pages/People/Component/employee.jsx,5,6,1
844739634062501289fe020611d2bfb218f7087a,codal-jsojitra,frontend/src/Pages/Projects/ProjectDetails/Component/project.jsx,3,4,1
844739634062501289fe020611d2bfb218f7087a,codal-jsojitra,frontend/src/Pages/Projects/ProjectList/Component/projectList.jsx,6,9,3
844739634062501289fe020611d2bfb218f7087a,codal-jsojitra,frontend/src/Pages/UserProfile/Profile/Component/profile.jsx,17,35,18
7145a24936d021eefa1b3141b71cfce7d1dedb30,codal-jsojitra,frontend/src/Actions/index.js,0,2,2
7145a24936d021eefa1b3141b71cfce7d1dedb30,codal-jsojitra,frontend/src/Assets/css/scss/style.scss,0,4,4
7145a24936d021eefa1b3141b71cfce7d1dedb30,codal-jsojitra,frontend/src/Pages/Projects/AddProject/Component/addProject.jsx,4,7,3
7145a24936d021eefa1b3141b71cfce7d1dedb30,codal-jsojitra,frontend/src/Pages/Projects/EditProject/Component/EditProject.js,3,9,6
7145a24936d021eefa1b3141b71cfce7d1dedb30,codal-jsojitra,frontend/src/Pages/Request/RequestResource/Component/AddRequest/AddRequest.jsx,2,4,2
7145a24936d021eefa1b3141b71cfce7d1dedb30,codal-jsojitra,frontend/src/Pages/UserProfile/Edit/Component/EditProfile.jsx,0,1,1
3d4fa188f8c47ac8e2b1fec2af12619335a95187,pkiri-codal,backend/requirements.txt,1,1,0
0e5d4ba97e3db3232ee38d900059afa7b7245948,pkiri-codal,backend/requirements.txt,1,1,0
d5f21c9a67aa466d1a42b8b1a41e3ee95e9df6e8,codal-sid,backend/rptool/admin.py,1,2,1
d5f21c9a67aa466d1a42b8b1a41e3ee95e9df6e8,codal-sid,backend/rptool/helpers.py,14,15,1
d5f21c9a67aa466d1a42b8b1a41e3ee95e9df6e8,codal-sid,backend/rptool/signals.py,27,50,23
456d1eca8abbc1dfd1a5288ca30e38559b9bee93,pkiri-codal,backend/rptool/signals.py,3,6,3
508cdd9e5b7dfa25d5b778759a55de89b84fccca,pkiri-codal,backend/rptool/helpers.py,1,2,1
508cdd9e5b7dfa25d5b778759a55de89b84fccca,pkiri-codal,backend/rptool/signals.py,18,36,18
e9cc6ecc0f1396d98fc423a9c07c740c4faf382a,pkiri-codal,backend/rptool/helpers.py,14,15,1
e9cc6ecc0f1396d98fc423a9c07c740c4faf382a,pkiri-codal,backend/rptool/signals.py,7,23,16
f490c90664ef558d635736b4ce4d2285ff8d5c5e,pkiri-codal,backend/rptool/admin.py,1,2,1
2e91afac4caf275435205dac42405badfd08b72b,pkiri-codal,backend/rptool/signals.py,1,2,1
b0edc4f9cffb0fc76b0e1de2db349e2f9fd611fa,pkiri-codal,backend/rptool/signals.py,2,4,2
98b323798c8e763e33f6ece8a639b3ee008d769b,pkiri-codal,backend/rptool/signals.py,8,15,7
7a86aafbc73d4cf83dc5b5ad106ae800f7a96eaa,pkiri-codal,frontend/public/index.html,1,6,5
7a86aafbc73d4cf83dc5b5ad106ae800f7a96eaa,pkiri-codal,frontend/src/Pages/People/Component/employee.jsx,7,14,7
7a86aafbc73d4cf83dc5b5ad106ae800f7a96eaa,pkiri-codal,frontend/src/Pages/UserProfile/Profile/Component/profile.jsx,10,27,17
6fdb792ece3683103788e4ab60152b9b23bf90f9,codal-sid,frontend/public/index.html,1,6,5
6fdb792ece3683103788e4ab60152b9b23bf90f9,codal-sid,frontend/src/Pages/People/Component/employee.jsx,7,14,7
6fdb792ece3683103788e4ab60152b9b23bf90f9,codal-sid,frontend/src/Pages/UserProfile/Profile/Component/profile.jsx,10,27,17
18bc4439c856fed905576964096265d332cce7a1,codal-jsojitra,frontend/public/index.html,1,6,5
18bc4439c856fed905576964096265d332cce7a1,codal-jsojitra,frontend/src/Pages/People/Component/employee.jsx,7,14,7
18bc4439c856fed905576964096265d332cce7a1,codal-jsojitra,frontend/src/Pages/UserProfile/Profile/Component/profile.jsx,10,27,17
82d2194a91d262a455aa52a6f66714e4ae2e7b47,pkiri-codal,backend/rptool/signals.py,5,9,4
ce352ba59ec43b7714057ba5d2e37c9ac70e72bf,pkiri-codal,backend/rptool/signals.py,12,29,17
1a568543aad46aa2d68139f72ea79be970b91e29,pkiri-codal,backend/rptool/signals.py,1,17,16
a72cbf92a5190e576feeb40c608ae581f88289d3,pkiri-codal,backend/rptool/serializers.py,0,21,21
a72cbf92a5190e576feeb40c608ae581f88289d3,pkiri-codal,backend/rptool/signals.py,31,31,0
6630960c4b2fdbdbc2ab48c1af52eff50f04ae6a,pkiri-codal,frontend/public/index.html,2,4,2
1bccb21adaa927f7c430a4e4d5a42f0d3ae75cf3,ppatelcodal,frontend/public/index.html,2,4,2
a9ac9847b45ea87222d206772122c1c8d40edccf,codal-jsojitra,frontend/public/index.html,2,4,2
ff89c2f64ff8201278a971d17573fd326ae0487e,pkiri-codal,backend/rptool/serializers.py,21,21,0
2b4b26172faa710605a998b172408509900e2f90,codal-sid,backend/customers/signals.py,4,4,0
2b4b26172faa710605a998b172408509900e2f90,codal-sid,backend/mainapp/celery_app.py,4,4,0
2b4b26172faa710605a998b172408509900e2f90,codal-sid,backend/rptool/tasks.py,113,224,111
e8aa7d1a594127aebee8b9be334b5dd61e487b27,codal-sid,backend/mainapp/celery_app.py,1,2,1
0a4bc4c0f4e4e8aaee569c3e92920b4ffd655884,codal-sid,backend/customers/signals.py,4,4,0
0a4bc4c0f4e4e8aaee569c3e92920b4ffd655884,codal-sid,backend/mainapp/celery_app.py,4,4,0
0a4bc4c0f4e4e8aaee569c3e92920b4ffd655884,codal-sid,backend/rptool/tasks.py,113,224,111
d611d99ad896286325635edb6afcc187df927d84,codal-jsojitra,frontend/src/Pages/Request/RequestResource/Component/RequestSubmit.jsx,3,6,3
d16c67e5ff761b0e5a18833ec0e064b54305524a,codal-jsojitra,frontend/src/Pages/Request/RequestResource/Component/RequestSubmit.jsx,3,6,3
de14d5a799b7230deb8b9c56946be881b461bc4e,codal-sid,frontend/package-lock.json,886,1835,949
de14d5a799b7230deb8b9c56946be881b461bc4e,codal-sid,frontend/src/App.js,1,2,1
de14d5a799b7230deb8b9c56946be881b461bc4e,codal-sid,frontend/src/Pages/Auth/Component/login.jsx,2,4,2
de14d5a799b7230deb8b9c56946be881b461bc4e,codal-sid,frontend/src/Pages/Common/Component/Header.jsx,4,10,6
de14d5a799b7230deb8b9c56946be881b461bc4e,codal-sid,frontend/src/Pages/Dashboard/Component/dashboard.jsx,0,31,31
de14d5a799b7230deb8b9c56946be881b461bc4e,codal-sid,frontend/src/Pages/Dashboard/Container/index.js,0,19,19
de14d5a799b7230deb8b9c56946be881b461bc4e,codal-sid,frontend/src/Pages/Organization/Component/Organization.jsx,3,6,3
de14d5a799b7230deb8b9c56946be881b461bc4e,codal-sid,frontend/src/Pages/People/Component/employee.jsx,2,4,2
de14d5a799b7230deb8b9c56946be881b461bc4e,codal-sid,frontend/src/Pages/People/Component/people.jsx,2,4,2
de14d5a799b7230deb8b9c56946be881b461bc4e,codal-sid,frontend/src/Pages/People/Component/upcoming.jsx,2,4,2
de14d5a799b7230deb8b9c56946be881b461bc4e,codal-sid,frontend/src/Pages/Projects/AddProject/Component/addProject.jsx,3,6,3
de14d5a799b7230deb8b9c56946be881b461bc4e,codal-sid,frontend/src/Pages/Projects/EditProject/Component/EditProject.js,8,16,8
de14d5a799b7230deb8b9c56946be881b461bc4e,codal-sid,frontend/src/Pages/Projects/ProjectDetails/Component/project.jsx,13,26,13
de14d5a799b7230deb8b9c56946be881b461bc4e,codal-sid,frontend/src/Pages/Projects/ProjectList/Component/projectList.jsx,4,8,4
de14d5a799b7230deb8b9c56946be881b461bc4e,codal-sid,frontend/src/Pages/Request/EditChangeAllocation/Component/EditAllocation.jsx,3,6,3
de14d5a799b7230deb8b9c56946be881b461bc4e,codal-sid,frontend/src/Pages/Request/EditMoveAllocation/Component/EditMoveResource.jsx,3,6,3
de14d5a799b7230deb8b9c56946be881b461bc4e,codal-sid,frontend/src/Pages/Request/EditRequest/Component/EditResource.jsx,2,4,2
de14d5a799b7230deb8b9c56946be881b461bc4e,codal-sid,frontend/src/Pages/Request/RequestList/Component/request.jsx,6,11,5
de14d5a799b7230deb8b9c56946be881b461bc4e,codal-sid,frontend/src/Pages/Request/RequestResource/Component/AddRequest/AddRequest.jsx,2,4,2
de14d5a799b7230deb8b9c56946be881b461bc4e,codal-sid,frontend/src/Pages/Request/RequestResource/Component/EditResource/Component/EditRequest.jsx,4,19,15
de14d5a799b7230deb8b9c56946be881b461bc4e,codal-sid,frontend/src/Pages/Request/RequestResource/Component/MoveResourceStep/Component/MoveResource.jsx,3,13,10
de14d5a799b7230deb8b9c56946be881b461bc4e,codal-sid,frontend/src/Pages/Request/RequestResource/Component/MoveResourceStep/Component/Step1.jsx,5,10,5
de14d5a799b7230deb8b9c56946be881b461bc4e,codal-sid,frontend/src/Pages/Request/RequestResource/Component/MoveResourceStep/Component/Step2.jsx,3,6,3
de14d5a799b7230deb8b9c56946be881b461bc4e,codal-sid,frontend/src/Pages/Request/RequestResource/Component/RequestSubmit.jsx,3,6,3
de14d5a799b7230deb8b9c56946be881b461bc4e,codal-sid,frontend/src/Pages/UserProfile/Edit/Component/EditProfile.jsx,2,4,2
de14d5a799b7230deb8b9c56946be881b461bc4e,codal-sid,frontend/src/Pages/UserProfile/Profile/Component/profile.jsx,5,10,5
de14d5a799b7230deb8b9c56946be881b461bc4e,codal-sid,package-lock.json,0,159,159
de14d5a799b7230deb8b9c56946be881b461bc4e,codal-sid,package.json,8,8,0
9c3b59ed97ef859373c43f609ddb17394fbef09d,codal-jsojitra,frontend/src/Pages/Auth/Component/login.jsx,1,2,1
9c3b59ed97ef859373c43f609ddb17394fbef09d,codal-jsojitra,frontend/src/Pages/Common/Component/Header.jsx,3,8,5
9c3b59ed97ef859373c43f609ddb17394fbef09d,codal-jsojitra,frontend/src/Pages/Organization/Component/Organization.jsx,1,2,1
9c3b59ed97ef859373c43f609ddb17394fbef09d,codal-jsojitra,frontend/src/Pages/Projects/EditProject/Component/EditProject.js,6,12,6
9c3b59ed97ef859373c43f609ddb17394fbef09d,codal-jsojitra,frontend/src/Pages/Projects/ProjectDetails/Component/project.jsx,11,22,11
9c3b59ed97ef859373c43f609ddb17394fbef09d,codal-jsojitra,frontend/src/Pages/Projects/ProjectList/Component/projectList.jsx,2,4,2
9c3b59ed97ef859373c43f609ddb17394fbef09d,codal-jsojitra,frontend/src/Pages/Request/EditChangeAllocation/Component/EditAllocation.jsx,1,2,1
9c3b59ed97ef859373c43f609ddb17394fbef09d,codal-jsojitra,frontend/src/Pages/Request/EditMoveAllocation/Component/EditMoveResource.jsx,1,2,1
9c3b59ed97ef859373c43f609ddb17394fbef09d,codal-jsojitra,frontend/src/Pages/Request/RequestList/Component/request.jsx,4,7,3
9c3b59ed97ef859373c43f609ddb17394fbef09d,codal-jsojitra,frontend/src/Pages/Request/RequestResource/Component/EditResource/Component/EditRequest.jsx,3,6,3
9c3b59ed97ef859373c43f609ddb17394fbef09d,codal-jsojitra,frontend/src/Pages/Request/RequestResource/Component/MoveResourceStep/Component/Step1.jsx,3,6,3
9c3b59ed97ef859373c43f609ddb17394fbef09d,codal-jsojitra,frontend/src/Pages/Request/RequestResource/Component/MoveResourceStep/Component/Step2.jsx,1,2,1
9c3b59ed97ef859373c43f609ddb17394fbef09d,codal-jsojitra,frontend/src/Pages/UserProfile/Profile/Component/profile.jsx,3,6,3
98784ef47e7fe0a430e8bc85e906e4e4b5aa9c31,codal-jsojitra,frontend/src/App.js,1,2,1
98784ef47e7fe0a430e8bc85e906e4e4b5aa9c31,codal-jsojitra,frontend/src/Pages/Auth/Component/login.jsx,1,2,1
98784ef47e7fe0a430e8bc85e906e4e4b5aa9c31,codal-jsojitra,frontend/src/Pages/Common/Component/Header.jsx,1,2,1
98784ef47e7fe0a430e8bc85e906e4e4b5aa9c31,codal-jsojitra,frontend/src/Pages/Dashboard/Component/dashboard.jsx,0,31,31
98784ef47e7fe0a430e8bc85e906e4e4b5aa9c31,codal-jsojitra,frontend/src/Pages/Dashboard/Container/index.js,0,19,19
98784ef47e7fe0a430e8bc85e906e4e4b5aa9c31,codal-jsojitra,frontend/src/Pages/Organization/Component/Organization.jsx,2,4,2
98784ef47e7fe0a430e8bc85e906e4e4b5aa9c31,codal-jsojitra,frontend/src/Pages/People/Component/employee.jsx,2,4,2
98784ef47e7fe0a430e8bc85e906e4e4b5aa9c31,codal-jsojitra,frontend/src/Pages/People/Component/people.jsx,2,4,2
98784ef47e7fe0a430e8bc85e906e4e4b5aa9c31,codal-jsojitra,frontend/src/Pages/People/Component/upcoming.jsx,2,4,2
98784ef47e7fe0a430e8bc85e906e4e4b5aa9c31,codal-jsojitra,frontend/src/Pages/Projects/AddProject/Component/addProject.jsx,3,6,3
98784ef47e7fe0a430e8bc85e906e4e4b5aa9c31,codal-jsojitra,frontend/src/Pages/Projects/EditProject/Component/EditProject.js,2,4,2
98784ef47e7fe0a430e8bc85e906e4e4b5aa9c31,codal-jsojitra,frontend/src/Pages/Projects/ProjectDetails/Component/project.jsx,2,4,2
98784ef47e7fe0a430e8bc85e906e4e4b5aa9c31,codal-jsojitra,frontend/src/Pages/Projects/ProjectList/Component/projectList.jsx,2,4,2
98784ef47e7fe0a430e8bc85e906e4e4b5aa9c31,codal-jsojitra,frontend/src/Pages/Request/EditChangeAllocation/Component/EditAllocation.jsx,2,4,2
98784ef47e7fe0a430e8bc85e906e4e4b5aa9c31,codal-jsojitra,frontend/src/Pages/Request/EditMoveAllocation/Component/EditMoveResource.jsx,2,4,2
98784ef47e7fe0a430e8bc85e906e4e4b5aa9c31,codal-jsojitra,frontend/src/Pages/Request/EditRequest/Component/EditResource.jsx,2,4,2
98784ef47e7fe0a430e8bc85e906e4e4b5aa9c31,codal-jsojitra,frontend/src/Pages/Request/RequestList/Component/request.jsx,2,4,2
98784ef47e7fe0a430e8bc85e906e4e4b5aa9c31,codal-jsojitra,frontend/src/Pages/Request/RequestResource/Component/AddRequest/AddRequest.jsx,2,4,2
98784ef47e7fe0a430e8bc85e906e4e4b5aa9c31,codal-jsojitra,frontend/src/Pages/Request/RequestResource/Component/EditResource/Component/EditRequest.jsx,1,13,12
98784ef47e7fe0a430e8bc85e906e4e4b5aa9c31,codal-jsojitra,frontend/src/Pages/Request/RequestResource/Component/MoveResourceStep/Component/MoveResource.jsx,3,13,10
98784ef47e7fe0a430e8bc85e906e4e4b5aa9c31,codal-jsojitra,frontend/src/Pages/Request/RequestResource/Component/MoveResourceStep/Component/Step1.jsx,2,4,2
98784ef47e7fe0a430e8bc85e906e4e4b5aa9c31,codal-jsojitra,frontend/src/Pages/Request/RequestResource/Component/MoveResourceStep/Component/Step2.jsx,2,4,2
98784ef47e7fe0a430e8bc85e906e4e4b5aa9c31,codal-jsojitra,frontend/src/Pages/Request/RequestResource/Component/RequestSubmit.jsx,2,4,2
98784ef47e7fe0a430e8bc85e906e4e4b5aa9c31,codal-jsojitra,frontend/src/Pages/UserProfile/Edit/Component/EditProfile.jsx,2,4,2
98784ef47e7fe0a430e8bc85e906e4e4b5aa9c31,codal-jsojitra,frontend/src/Pages/UserProfile/Profile/Component/profile.jsx,2,4,2
7eff5fbbadd24b0e717889bde29d2016db917124,codal-jsojitra,frontend/package.json,0,6,6
7eff5fbbadd24b0e717889bde29d2016db917124,codal-jsojitra,package.json,8,8,0
3a7a7d190c416518797f630b2c588387cc39be1c,codal-jsojitra,frontend/package-lock.json,886,1835,949
3a7a7d190c416518797f630b2c588387cc39be1c,codal-jsojitra,frontend/package.json,6,6,0
3a7a7d190c416518797f630b2c588387cc39be1c,codal-jsojitra,frontend/src/Pages/Request/RequestResource/Component/RequestSubmit.jsx,1,2,1
3a7a7d190c416518797f630b2c588387cc39be1c,codal-jsojitra,package-lock.json,0,159,159
9a393ccf11ddcfaea3738c2447bf8ad1229f3f4e,codal-sid,backend/rptool/migrations/0040_auto_20200603_0931.py,34,34,0
9a393ccf11ddcfaea3738c2447bf8ad1229f3f4e,codal-sid,backend/rptool/models.py,5,5,0
9a393ccf11ddcfaea3738c2447bf8ad1229f3f4e,codal-sid,backend/rptool/serializers.py,15,19,4
9a393ccf11ddcfaea3738c2447bf8ad1229f3f4e,codal-sid,backend/rptool/swagger_fields.py,7,8,1
9a393ccf11ddcfaea3738c2447bf8ad1229f3f4e,codal-sid,backend/rptool/views.py,1,3,2
892afc8a384f626dc6aa1c298abf2bb8fb89bb8f,pkiri-codal,backend/rptool/serializers.py,1,2,1
5c8b0b1b0662da3d9b7e6a53a4e504f79ac0230a,pkiri-codal,backend/rptool/serializers.py,1,2,1
3b4cc7b2eefd88aeaef2ab747deb5af1bb903c23,pkiri-codal,backend/rptool/serializers.py,2,9,7
665e04df220f8b3bdffb2d11bb7772ddfb2a056b,pkiri-codal,backend/rptool/serializers.py,1,2,1
66482293f4ceea4797fa3aa5deef5980e7ceff2f,pkiri-codal,backend/rptool/serializers.py,6,7,1
3bc2dec2f2715a8b6e715a104175700bb2728f8c,pkiri-codal,backend/rptool/serializers.py,3,8,5
447a8629f1027983f38a08cd1fd4eae787567955,pkiri-codal,backend/rptool/serializers.py,7,17,10
f2a310983cbbdd18d4d4c8f2018f98f0b6e97c5d,pkiri-codal,backend/rptool/serializers.py,10,13,3
fe7c2a3122a6a2639d176fa14448b2180a4a454d,pkiri-codal,backend/rptool/serializers.py,3,3,0
d53db848acd240a4d9293b418c1ae30a493feae4,pkiri-codal,backend/rptool/models.py,4,6,2
61c385fc163a057591128dbe2969116e2541bde2,pkiri-codal,backend/rptool/models.py,1,3,2
3d51d0b22f32f7d0b1589fbf38a17c275568f827,pkiri-codal,backend/rptool/views.py,1,3,2
dafd77724c74df09d7877f768867acab792269e1,pkiri-codal,backend/rptool/serializers.py,3,6,3
b729bbd15c6402512f54fc22c383d7fd9cb0ce88,pkiri-codal,backend/rptool/serializers.py,2,4,2
7a129bd281eca6ffecedc851cdf833469c1b4d28,pkiri-codal,backend/rptool/models.py,2,4,2
7a129bd281eca6ffecedc851cdf833469c1b4d28,pkiri-codal,backend/rptool/serializers.py,6,12,6
4ea98eff9f606496a0cd9888f4b337c39d012172,pkiri-codal,backend/rptool/serializers.py,10,30,20
665b98225df27c138c63d20dfd728645ed60d22f,pkiri-codal,backend/rptool/serializers.py,3,6,3
97d7cd360f25f64a4410653147e7ebd90cf301cb,pkiri-codal,backend/rptool/serializers.py,16,75,59
96133404b7b313293b1dcf77197069eb439f7a48,pkiri-codal,backend/rptool/serializers.py,6,9,3
19ab8ffa044221631071b15bd2420f2fc1881a12,pkiri-codal,backend/rptool/serializers.py,60,64,4
4d26c911da81919eedf4d5d847da55aa16fc7af3,pkiri-codal,backend/rptool/views.py,1,2,1
dccf229dc29e4e99f3075489aaf7590b30599719,codal-sid,backend/rptool/views.py,1,2,1
30dea91f618f1a7934c4f63f6c2534f86e38b1a9,sshaikhcodal,backend/rptool/views.py,1,2,1
ba1eede70ae54cf0b007ad48a8dfdcd471bb78bc,pkiri-codal,backend/rptool/migrations/0040_auto_20200603_0931.py,34,34,0
ba1eede70ae54cf0b007ad48a8dfdcd471bb78bc,pkiri-codal,backend/rptool/models.py,4,4,0
ba1eede70ae54cf0b007ad48a8dfdcd471bb78bc,pkiri-codal,backend/rptool/serializers.py,3,6,3
ba1eede70ae54cf0b007ad48a8dfdcd471bb78bc,pkiri-codal,backend/rptool/swagger_fields.py,7,8,1
ba1eede70ae54cf0b007ad48a8dfdcd471bb78bc,pkiri-codal,backend/rptool/views.py,1,2,1
68bcf177544f8caf7720b3a4761d4a169bb6fc97,codal-sid,frontend/src/Actions/index.js,38,39,1
68bcf177544f8caf7720b3a4761d4a169bb6fc97,codal-sid,frontend/src/Actions/type.js,3,3,0
68bcf177544f8caf7720b3a4761d4a169bb6fc97,codal-sid,frontend/src/Assets/Json/DataTable.js,195,390,195
68bcf177544f8caf7720b3a4761d4a169bb6fc97,codal-sid,frontend/src/Assets/css/scss/_profile.scss,8,8,0
68bcf177544f8caf7720b3a4761d4a169bb6fc97,codal-sid,frontend/src/Assets/css/scss/style.css,4,4,0
68bcf177544f8caf7720b3a4761d4a169bb6fc97,codal-sid,frontend/src/Assets/css/scss/style.css.map,1,2,1
68bcf177544f8caf7720b3a4761d4a169bb6fc97,codal-sid,frontend/src/Pages/UserProfile/Profile/Component/profile.jsx,65,79,14
68bcf177544f8caf7720b3a4761d4a169bb6fc97,codal-sid,frontend/src/Pages/UserProfile/Profile/Container/index.js,6,8,2
68bcf177544f8caf7720b3a4761d4a169bb6fc97,codal-sid,frontend/src/Reducers/User/GetUserTimeLog.js,19,19,0
68bcf177544f8caf7720b3a4761d4a169bb6fc97,codal-sid,frontend/src/Reducers/index.js,4,5,1
b0958de70b900f296485be5d1ec6f9d6b89bdfbd,codal-jsojitra,frontend/src/Pages/UserProfile/Profile/Component/profile.jsx,2,4,2
3e9a9d8000d4437869737585dc53dd674c6de377,codal-sid,backend/rptool/permissions.py,1,4,3
3e9a9d8000d4437869737585dc53dd674c6de377,codal-sid,backend/rptool/views.py,70,70,0
1a42210857b3a0851a198254326cc76b451cd380,sshaikhcodal,backend/rptool/permissions.py,0,2,2
95a81240912b6c1b6e969c0395a47d7e9cf8cb6c,sshaikhcodal,backend/.swp,0,0,0
95a81240912b6c1b6e969c0395a47d7e9cf8cb6c,sshaikhcodal,backend/a.out,0,0,0
39db04a9ebc2d1f5a2f5e5e8f6df1d9726b4ea7f,sshaikhcodal,backend/rptool/views.py,4,11,7
97f4739d4efa32a1cd3d807965638d1211cb3414,sshaikhcodal,backend/rptool/views.py,45,105,60
8be95f6f6e1e5c2590ea6a6f5430f95619513de2,sshaikhcodal,backend/rptool/views.py,61,102,41
44563f8e2fa9e98c8ce6741083d186b34e52e86d,sshaikhcodal,backend/.swp,0,0,0
44563f8e2fa9e98c8ce6741083d186b34e52e86d,sshaikhcodal,backend/a.out,0,0,0
44563f8e2fa9e98c8ce6741083d186b34e52e86d,sshaikhcodal,backend/rptool/permissions.py,1,2,1
44563f8e2fa9e98c8ce6741083d186b34e52e86d,sshaikhcodal,backend/rptool/views.py,68,68,0
25b69a6bb3d6e18b1601c84a2143be0bc2cd1387,codal-jsojitra,frontend/src/Actions/index.js,38,39,1
25b69a6bb3d6e18b1601c84a2143be0bc2cd1387,codal-jsojitra,frontend/src/Actions/type.js,3,3,0
25b69a6bb3d6e18b1601c84a2143be0bc2cd1387,codal-jsojitra,frontend/src/Assets/Json/DataTable.js,195,390,195
25b69a6bb3d6e18b1601c84a2143be0bc2cd1387,codal-jsojitra,frontend/src/Assets/css/scss/_profile.scss,8,8,0
25b69a6bb3d6e18b1601c84a2143be0bc2cd1387,codal-jsojitra,frontend/src/Assets/css/scss/style.css,4,4,0
25b69a6bb3d6e18b1601c84a2143be0bc2cd1387,codal-jsojitra,frontend/src/Assets/css/scss/style.css.map,1,2,1
25b69a6bb3d6e18b1601c84a2143be0bc2cd1387,codal-jsojitra,frontend/src/Pages/UserProfile/Profile/Component/profile.jsx,65,79,14
25b69a6bb3d6e18b1601c84a2143be0bc2cd1387,codal-jsojitra,frontend/src/Pages/UserProfile/Profile/Container/index.js,6,8,2
25b69a6bb3d6e18b1601c84a2143be0bc2cd1387,codal-jsojitra,frontend/src/Reducers/User/GetUserTimeLog.js,19,19,0
25b69a6bb3d6e18b1601c84a2143be0bc2cd1387,codal-jsojitra,frontend/src/Reducers/index.js,4,5,1
e93781a54d830e62f53674c71cfb3d4a229f99ac,codal-sid,frontend/src/Pages/Projects/EditProject/Component/EditProject.js,2,4,2
e93781a54d830e62f53674c71cfb3d4a229f99ac,codal-sid,frontend/src/Pages/UserProfile/Edit/Component/EditProfile.jsx,33,43,10
e93781a54d830e62f53674c71cfb3d4a229f99ac,codal-sid,frontend/src/Pages/UserProfile/Edit/Container/index.js,5,6,1
e93781a54d830e62f53674c71cfb3d4a229f99ac,codal-sid,frontend/src/Pages/UserProfile/Profile/Component/profile.jsx,53,56,3
54fd49723812e7bc5e0e1407f881998d7a6af893,codal-jsojitra,frontend/src/Pages/UserProfile/Edit/Component/EditProfile.jsx,33,43,10
54fd49723812e7bc5e0e1407f881998d7a6af893,codal-jsojitra,frontend/src/Pages/UserProfile/Edit/Container/index.js,5,6,1
54fd49723812e7bc5e0e1407f881998d7a6af893,codal-jsojitra,frontend/src/Pages/UserProfile/Profile/Component/profile.jsx,53,56,3
5d18f5197100e729b0430cb5fa775557265f8cfe,codal-sid,backend/rptool/serializers.py,1,2,1
9ffe43377bee876a78f2fb09cbd1707728490d87,codal-jsojitra,frontend/src/Pages/Projects/EditProject/Component/EditProject.js,2,4,2
78267689738ce1d72d7abc823e4d306a7f7ff57b,codal-sid,backend/rptool/serializers.py,1,2,1
e2ca8c626a1983d24bc919a3e29f50acd7bca8f6,codal-sid,backend/rptool/migrations/0039_auto_20200520_0917.py,23,23,0
e2ca8c626a1983d24bc919a3e29f50acd7bca8f6,codal-sid,backend/rptool/models.py,1,1,0
e2ca8c626a1983d24bc919a3e29f50acd7bca8f6,codal-sid,backend/rptool/serializers.py,32,40,8
e2ca8c626a1983d24bc919a3e29f50acd7bca8f6,codal-sid,backend/rptool/views.py,2,4,2
8c5f4c37f03b720b0c1d46d3544e81bc505646d1,codal-sid,frontend/src/Pages/Projects/EditProject/Component/EditProject.js,2,3,1
8c5f4c37f03b720b0c1d46d3544e81bc505646d1,codal-sid,frontend/src/Pages/Request/EditChangeAllocation/Component/EditAllocation.jsx,40,58,18
8c5f4c37f03b720b0c1d46d3544e81bc505646d1,codal-sid,frontend/src/Pages/Request/EditMoveAllocation/Component/EditMoveResource.jsx,40,59,19
8c5f4c37f03b720b0c1d46d3544e81bc505646d1,codal-sid,frontend/src/Pages/Request/RequestList/Component/request.jsx,21,28,7
8c5f4c37f03b720b0c1d46d3544e81bc505646d1,codal-sid,frontend/src/Pages/Request/RequestResource/Component/EditResource/Component/EditRequest.jsx,42,59,17
8c5f4c37f03b720b0c1d46d3544e81bc505646d1,codal-sid,frontend/src/Pages/Request/RequestResource/Component/MoveResourceStep/Component/MoveResource.jsx,3,5,2
8c5f4c37f03b720b0c1d46d3544e81bc505646d1,codal-sid,frontend/src/Pages/Request/RequestResource/Component/MoveResourceStep/Component/Step2.jsx,30,47,17
216f2e7a20190852893dd0b5efde10716edc38bd,codal-sid,backend/rptool/migrations/0039_auto_20200520_0917.py,23,23,0
216f2e7a20190852893dd0b5efde10716edc38bd,codal-sid,backend/rptool/models.py,1,1,0
216f2e7a20190852893dd0b5efde10716edc38bd,codal-sid,backend/rptool/serializers.py,32,40,8
216f2e7a20190852893dd0b5efde10716edc38bd,codal-sid,backend/rptool/views.py,2,4,2
93eb2e68121fcce7bbcf9af85d045cc467bca9ff,codal-sid,frontend/src/Pages/Projects/EditProject/Component/EditProject.js,2,3,1
93eb2e68121fcce7bbcf9af85d045cc467bca9ff,codal-sid,frontend/src/Pages/Request/EditChangeAllocation/Component/EditAllocation.jsx,40,58,18
93eb2e68121fcce7bbcf9af85d045cc467bca9ff,codal-sid,frontend/src/Pages/Request/EditMoveAllocation/Component/EditMoveResource.jsx,40,59,19
93eb2e68121fcce7bbcf9af85d045cc467bca9ff,codal-sid,frontend/src/Pages/Request/RequestList/Component/request.jsx,21,28,7
93eb2e68121fcce7bbcf9af85d045cc467bca9ff,codal-sid,frontend/src/Pages/Request/RequestResource/Component/EditResource/Component/EditRequest.jsx,42,59,17
93eb2e68121fcce7bbcf9af85d045cc467bca9ff,codal-sid,frontend/src/Pages/Request/RequestResource/Component/MoveResourceStep/Component/MoveResource.jsx,3,5,2
93eb2e68121fcce7bbcf9af85d045cc467bca9ff,codal-sid,frontend/src/Pages/Request/RequestResource/Component/MoveResourceStep/Component/Step2.jsx,30,47,17
a26862a31f16cc1d027a7ed94d250cf5e3801f92,codal-jsojitra,frontend/src/Pages/Projects/EditProject/Component/EditProject.js,2,3,1
a26862a31f16cc1d027a7ed94d250cf5e3801f92,codal-jsojitra,frontend/src/Pages/Request/EditChangeAllocation/Component/EditAllocation.jsx,40,58,18
a26862a31f16cc1d027a7ed94d250cf5e3801f92,codal-jsojitra,frontend/src/Pages/Request/EditMoveAllocation/Component/EditMoveResource.jsx,40,59,19
a26862a31f16cc1d027a7ed94d250cf5e3801f92,codal-jsojitra,frontend/src/Pages/Request/RequestList/Component/request.jsx,21,28,7
a26862a31f16cc1d027a7ed94d250cf5e3801f92,codal-jsojitra,frontend/src/Pages/Request/RequestResource/Component/EditResource/Component/EditRequest.jsx,42,59,17
a26862a31f16cc1d027a7ed94d250cf5e3801f92,codal-jsojitra,frontend/src/Pages/Request/RequestResource/Component/MoveResourceStep/Component/MoveResource.jsx,3,5,2
a26862a31f16cc1d027a7ed94d250cf5e3801f92,codal-jsojitra,frontend/src/Pages/Request/RequestResource/Component/MoveResourceStep/Component/Step2.jsx,30,47,17
728be2124ff97338164bca53a070448b087e1f87,codal-sid,backend/rptool/views.py,16,25,9
e2f8d67839ccb56c32ba6a8cbb3ce1ca7bdd412b,codal-sid,backend/rptool/views.py,16,25,9
6eb6a2819fd568133a44acd6539c4a12e40c28ea,codal-sid,frontend/src/Pages/UserProfile/Profile/Component/profile.jsx,12,22,10
c7c43d80c9542f3fd69abf118dcf5413c0ae5798,codal-jsojitra,frontend/src/Pages/UserProfile/Profile/Component/profile.jsx,10,21,11
5bfe3e6811811ce5b1a26279e0bc508434dfdf19,codal-jsojitra,frontend/src/Pages/UserProfile/Profile/Component/profile.jsx,6,9,3
018fd5415dd5d00cd89ee6ab8dbe87b95a9d5e1e,codal-sid,frontend/src/Pages/People/Component/employee.jsx,33,40,7
018fd5415dd5d00cd89ee6ab8dbe87b95a9d5e1e,codal-sid,frontend/src/Pages/Projects/ProjectDetails/Component/project.jsx,2,4,2
181e27f09da212fee1d70d4e1447659768171d3a,codal-jsojitra,frontend/src/Pages/People/Component/employee.jsx,1,5,4
6c0e2270595c1efef6a28344b6a32096902eb476,codal-jsojitra,frontend/src/Pages/People/Component/employee.jsx,33,37,4
6c0e2270595c1efef6a28344b6a32096902eb476,codal-jsojitra,frontend/src/Pages/Projects/ProjectDetails/Component/project.jsx,2,4,2
e015bf8f22520af56565e47d9af357509ad510e4,codal-sid,backend/rptool/views.py,15,17,2
4c7312cb5c479a753a82228568eb7e60108d6d82,codal-sid,backend/rptool/views.py,15,17,2
730fa81683008fea1201d3920b90c87aa9b8360d,codal-sid,frontend/src/Actions/index.js,2,4,2
730fa81683008fea1201d3920b90c87aa9b8360d,codal-sid,frontend/src/Assets/Json/DataTable.js,200,338,138
730fa81683008fea1201d3920b90c87aa9b8360d,codal-sid,frontend/src/Assets/css/scss/_datatable.scss,3,3,0
730fa81683008fea1201d3920b90c87aa9b8360d,codal-sid,frontend/src/Assets/css/scss/style.css,4,4,0
730fa81683008fea1201d3920b90c87aa9b8360d,codal-sid,frontend/src/Assets/css/scss/style.css.map,1,2,1
730fa81683008fea1201d3920b90c87aa9b8360d,codal-sid,frontend/src/Pages/Projects/ProjectDetails/Component/project.jsx,3,6,3
730fa81683008fea1201d3920b90c87aa9b8360d,codal-sid,frontend/src/Pages/UserProfile/Profile/Component/profile.jsx,102,212,110
c3fa8d051fe830d94a71337d3c4de2febab6156c,codal-jsojitra,frontend/src/Actions/index.js,2,4,2
c3fa8d051fe830d94a71337d3c4de2febab6156c,codal-jsojitra,frontend/src/Assets/Json/DataTable.js,200,338,138
c3fa8d051fe830d94a71337d3c4de2febab6156c,codal-jsojitra,frontend/src/Assets/css/scss/_datatable.scss,3,3,0
c3fa8d051fe830d94a71337d3c4de2febab6156c,codal-jsojitra,frontend/src/Assets/css/scss/style.css,4,4,0
c3fa8d051fe830d94a71337d3c4de2febab6156c,codal-jsojitra,frontend/src/Assets/css/scss/style.css.map,1,2,1
c3fa8d051fe830d94a71337d3c4de2febab6156c,codal-jsojitra,frontend/src/Pages/Projects/ProjectDetails/Component/project.jsx,3,6,3
c3fa8d051fe830d94a71337d3c4de2febab6156c,codal-jsojitra,frontend/src/Pages/UserProfile/Profile/Component/profile.jsx,102,212,110
551ceedb2e20f72baf1748eb261915e1d37f29da,codal-sid,frontend/src/Assets/Json/DataTable.js,154,154,0
551ceedb2e20f72baf1748eb261915e1d37f29da,codal-sid,frontend/src/Assets/css/scss/_datatable.scss,171,171,0
551ceedb2e20f72baf1748eb261915e1d37f29da,codal-sid,frontend/src/Assets/css/scss/_project.scss,4,4,0
551ceedb2e20f72baf1748eb261915e1d37f29da,codal-sid,frontend/src/Assets/css/scss/style.css,146,146,0
551ceedb2e20f72baf1748eb261915e1d37f29da,codal-sid,frontend/src/Assets/css/scss/style.css.map,1,2,1
551ceedb2e20f72baf1748eb261915e1d37f29da,codal-sid,frontend/src/Assets/css/scss/style.scss,1,1,0
551ceedb2e20f72baf1748eb261915e1d37f29da,codal-sid,frontend/src/Pages/Projects/ProjectDetails/Component/project.jsx,150,311,161
551ceedb2e20f72baf1748eb261915e1d37f29da,codal-sid,frontend/src/Pages/Request/EditRequest/Component/EditResource.jsx,2,8,6
551ceedb2e20f72baf1748eb261915e1d37f29da,codal-sid,frontend/src/Pages/Request/RequestResource/Component/AddRequest/AddRequest.jsx,4,16,12
024028ed6f66b1632bd75dfa384fa298ec9d0fb1,codal-jsojitra,frontend/src/Assets/Json/DataTable.js,47,47,0
024028ed6f66b1632bd75dfa384fa298ec9d0fb1,codal-jsojitra,frontend/src/Assets/css/scss/_datatable.scss,102,102,0
024028ed6f66b1632bd75dfa384fa298ec9d0fb1,codal-jsojitra,frontend/src/Assets/css/scss/_project.scss,4,4,0
024028ed6f66b1632bd75dfa384fa298ec9d0fb1,codal-jsojitra,frontend/src/Assets/css/scss/style.css,88,88,0
024028ed6f66b1632bd75dfa384fa298ec9d0fb1,codal-jsojitra,frontend/src/Assets/css/scss/style.css.map,1,2,1
024028ed6f66b1632bd75dfa384fa298ec9d0fb1,codal-jsojitra,frontend/src/Pages/Projects/ProjectDetails/Component/project.jsx,46,114,68
024028ed6f66b1632bd75dfa384fa298ec9d0fb1,codal-jsojitra,frontend/src/Pages/Request/EditRequest/Component/EditResource.jsx,2,8,6
024028ed6f66b1632bd75dfa384fa298ec9d0fb1,codal-jsojitra,frontend/src/Pages/Request/RequestResource/Component/AddRequest/AddRequest.jsx,4,16,12
d42ac5faad3ddce48bb565ac361c530ab6bcdb7c,codal-jsojitra,frontend/src/Assets/Json/DataTable.js,107,107,0
d42ac5faad3ddce48bb565ac361c530ab6bcdb7c,codal-jsojitra,frontend/src/Assets/css/scss/_datatable.scss,69,69,0
d42ac5faad3ddce48bb565ac361c530ab6bcdb7c,codal-jsojitra,frontend/src/Assets/css/scss/style.css,58,58,0
d42ac5faad3ddce48bb565ac361c530ab6bcdb7c,codal-jsojitra,frontend/src/Assets/css/scss/style.css.map,1,2,1
d42ac5faad3ddce48bb565ac361c530ab6bcdb7c,codal-jsojitra,frontend/src/Assets/css/scss/style.scss,1,1,0
d42ac5faad3ddce48bb565ac361c530ab6bcdb7c,codal-jsojitra,frontend/src/Pages/Projects/ProjectDetails/Component/project.jsx,111,211,100
d8dfe9128757d1fee4e83661ab6f635d0922c54b,codal-sid,frontend/public/manifest.json,2,14,12
d8dfe9128757d1fee4e83661ab6f635d0922c54b,codal-sid,frontend/src/Assets/css/scss/_profile.scss,16,16,0
d8dfe9128757d1fee4e83661ab6f635d0922c54b,codal-sid,frontend/src/Assets/css/scss/style.css,15,15,0
d8dfe9128757d1fee4e83661ab6f635d0922c54b,codal-sid,frontend/src/Assets/css/scss/style.css.map,1,2,1
d8dfe9128757d1fee4e83661ab6f635d0922c54b,codal-sid,frontend/src/Pages/Request/EditRequest/Component/EditResource.jsx,4,23,19
d8dfe9128757d1fee4e83661ab6f635d0922c54b,codal-sid,frontend/src/Pages/UserProfile/Edit/Component/EditProfile.jsx,17,33,16
d8dfe9128757d1fee4e83661ab6f635d0922c54b,codal-sid,frontend/src/index.js,1,2,1
5fffae4a5bcc9b55e5cf5d2226bf1e9b2d114e8b,codal-jsojitra,frontend/public/manifest.json,2,14,12
5fffae4a5bcc9b55e5cf5d2226bf1e9b2d114e8b,codal-jsojitra,frontend/src/index.js,1,2,1
16f5c682060d65b75c89840fd3d815b21f3b3e9a,codal-jsojitra,frontend/src/Assets/css/scss/_profile.scss,16,16,0
16f5c682060d65b75c89840fd3d815b21f3b3e9a,codal-jsojitra,frontend/src/Assets/css/scss/style.css,15,15,0
16f5c682060d65b75c89840fd3d815b21f3b3e9a,codal-jsojitra,frontend/src/Assets/css/scss/style.css.map,1,2,1
16f5c682060d65b75c89840fd3d815b21f3b3e9a,codal-jsojitra,frontend/src/Pages/UserProfile/Edit/Component/EditProfile.jsx,17,33,16
72aec7579448ffcbb95deb35a1a258255584c4ca,codal-jsojitra,frontend/src/Pages/Request/EditRequest/Component/EditResource.jsx,4,23,19
0f2071d8f001b3df6da7f6d44070c29fb708fcd0,codal-sid,frontend/public/favicon.ico,0,0,0
0f2071d8f001b3df6da7f6d44070c29fb708fcd0,codal-sid,frontend/public/favicon.png,0,0,0
0f2071d8f001b3df6da7f6d44070c29fb708fcd0,codal-sid,frontend/public/logo.svg,11,11,0
0f2071d8f001b3df6da7f6d44070c29fb708fcd0,codal-sid,frontend/public/logo192.png,0,0,0
0f2071d8f001b3df6da7f6d44070c29fb708fcd0,codal-sid,frontend/public/logo512.png,0,0,0
0f2071d8f001b3df6da7f6d44070c29fb708fcd0,codal-sid,frontend/public/manifest.json,17,23,6
0f2071d8f001b3df6da7f6d44070c29fb708fcd0,codal-sid,frontend/src/Pages/People/Component/employee.jsx,14,18,4
0f2071d8f001b3df6da7f6d44070c29fb708fcd0,codal-sid,frontend/src/Pages/Request/EditChangeAllocation/Component/EditAllocation.jsx,1,2,1
0f2071d8f001b3df6da7f6d44070c29fb708fcd0,codal-sid,frontend/src/Pages/Request/EditMoveAllocation/Component/EditMoveResource.jsx,5,9,4
0f2071d8f001b3df6da7f6d44070c29fb708fcd0,codal-sid,frontend/src/Pages/Request/EditRequest/Component/EditResource.jsx,1,2,1
0f2071d8f001b3df6da7f6d44070c29fb708fcd0,codal-sid,frontend/src/Pages/Request/RequestResource/Component/AddRequest/AddRequest.jsx,2,4,2
0f2071d8f001b3df6da7f6d44070c29fb708fcd0,codal-sid,frontend/src/Pages/Request/RequestResource/Component/EditResource/Component/EditRequest.jsx,1,2,1
0f2071d8f001b3df6da7f6d44070c29fb708fcd0,codal-sid,frontend/src/Pages/Request/RequestResource/Component/MoveResourceStep/Component/Step2.jsx,1,2,1
0f2071d8f001b3df6da7f6d44070c29fb708fcd0,codal-sid,frontend/src/serviceWorker.js,9,18,9
c6d5df72db159fa0628c9c6fa24f255d2805bc4d,codal-sid,backend/rptool/serializers.py,103,106,3
dc5049fece1370051e00b8134a10513da9245ddb,codal-sid,backend/rptool/serializers.py,29,30,1
5525779b2dd4ecf70c7d75572191c64d68a27e33,codal-jsojitra,frontend/src/Pages/Request/EditChangeAllocation/Component/EditAllocation.jsx,1,2,1
5525779b2dd4ecf70c7d75572191c64d68a27e33,codal-jsojitra,frontend/src/Pages/Request/EditMoveAllocation/Component/EditMoveResource.jsx,5,9,4
5525779b2dd4ecf70c7d75572191c64d68a27e33,codal-jsojitra,frontend/src/Pages/Request/EditRequest/Component/EditResource.jsx,1,2,1
5525779b2dd4ecf70c7d75572191c64d68a27e33,codal-jsojitra,frontend/src/Pages/Request/RequestResource/Component/AddRequest/AddRequest.jsx,2,4,2
5525779b2dd4ecf70c7d75572191c64d68a27e33,codal-jsojitra,frontend/src/Pages/Request/RequestResource/Component/EditResource/Component/EditRequest.jsx,1,2,1
5525779b2dd4ecf70c7d75572191c64d68a27e33,codal-jsojitra,frontend/src/Pages/Request/RequestResource/Component/MoveResourceStep/Component/Step2.jsx,1,2,1
21eded8d326b25ca6d00bb9b0aa4f9bbac19c05c,codal-sid,backend/rptool/serializers.py,75,78,3
55152e29d4a3db84fb253c1c3f641e2d8986375a,codal-jsojitra,frontend/public/favicon.ico,0,0,0
55152e29d4a3db84fb253c1c3f641e2d8986375a,codal-jsojitra,frontend/public/favicon.png,0,0,0
55152e29d4a3db84fb253c1c3f641e2d8986375a,codal-jsojitra,frontend/public/logo.svg,11,11,0
55152e29d4a3db84fb253c1c3f641e2d8986375a,codal-jsojitra,frontend/public/logo192.png,0,0,0
55152e29d4a3db84fb253c1c3f641e2d8986375a,codal-jsojitra,frontend/public/logo512.png,0,0,0
55152e29d4a3db84fb253c1c3f641e2d8986375a,codal-jsojitra,frontend/public/manifest.json,17,23,6
55152e29d4a3db84fb253c1c3f641e2d8986375a,codal-jsojitra,frontend/src/Pages/People/Component/employee.jsx,14,18,4
55152e29d4a3db84fb253c1c3f641e2d8986375a,codal-jsojitra,frontend/src/serviceWorker.js,9,18,9
d4b8f64bba7321166f1f76eb0482e3c2049298a8,codal-sid,frontend/src/Pages/Request/EditChangeAllocation/Component/EditAllocation.jsx,4,7,3
d4b8f64bba7321166f1f76eb0482e3c2049298a8,codal-sid,frontend/src/Pages/Request/EditRequest/Component/EditResource.jsx,8,9,1
d4b8f64bba7321166f1f76eb0482e3c2049298a8,codal-sid,frontend/src/Pages/Request/RequestList/Component/request.jsx,20,25,5
d4b8f64bba7321166f1f76eb0482e3c2049298a8,codal-sid,frontend/src/Pages/Request/RequestResource/Component/AddRequest/AddRequest.jsx,7,14,7
d4b8f64bba7321166f1f76eb0482e3c2049298a8,codal-sid,frontend/src/Pages/Request/RequestResource/Component/EditResource/Component/EditRequest.jsx,2,4,2
d4b8f64bba7321166f1f76eb0482e3c2049298a8,codal-sid,frontend/src/Pages/Request/RequestResource/Component/MoveResourceStep/Component/MoveResource.jsx,12,13,1
d4b8f64bba7321166f1f76eb0482e3c2049298a8,codal-sid,frontend/src/Pages/Request/RequestResource/Component/MoveResourceStep/Component/Step2.jsx,8,12,4
1528407b7eb226fd6607b7a44777f48be79c33b8,codal-sid,backend/rptool/serializers.py,179,207,28
1528407b7eb226fd6607b7a44777f48be79c33b8,codal-sid,backend/rptool/views.py,21,27,6
613bdc7e52c9cf0486a840cc0dd9255eb030608c,codal-sid,backend/rptool/serializers.py,6,12,6
9656e27ab6a81215e8e3f30b5aee7571c06e3677,codal-jsojitra,frontend/src/common/Config.js,1,2,1
08e0547fc1457006fb64af2135c5752742156ea1,codal-sid,backend/rptool/serializers.py,179,207,28
08e0547fc1457006fb64af2135c5752742156ea1,codal-sid,backend/rptool/views.py,21,27,6
df74e64995dd3c09f033d8bba7c48836d9312d64,codal-jsojitra,frontend/src/Pages/Request/EditChangeAllocation/Component/EditAllocation.jsx,4,7,3
df74e64995dd3c09f033d8bba7c48836d9312d64,codal-jsojitra,frontend/src/Pages/Request/EditRequest/Component/EditResource.jsx,8,9,1
df74e64995dd3c09f033d8bba7c48836d9312d64,codal-jsojitra,frontend/src/Pages/Request/RequestList/Component/request.jsx,20,25,5
df74e64995dd3c09f033d8bba7c48836d9312d64,codal-jsojitra,frontend/src/Pages/Request/RequestResource/Component/AddRequest/AddRequest.jsx,7,14,7
df74e64995dd3c09f033d8bba7c48836d9312d64,codal-jsojitra,frontend/src/Pages/Request/RequestResource/Component/EditResource/Component/EditRequest.jsx,2,4,2
df74e64995dd3c09f033d8bba7c48836d9312d64,codal-jsojitra,frontend/src/Pages/Request/RequestResource/Component/MoveResourceStep/Component/MoveResource.jsx,12,13,1
df74e64995dd3c09f033d8bba7c48836d9312d64,codal-jsojitra,frontend/src/Pages/Request/RequestResource/Component/MoveResourceStep/Component/Step2.jsx,8,12,4
df74e64995dd3c09f033d8bba7c48836d9312d64,codal-jsojitra,frontend/src/common/Config.js,1,2,1
611c029b243aba8a577b359ad11033fc6cb455fc,codal-sid,frontend/src/Assets/css/scss/_component.scss,16,16,0
611c029b243aba8a577b359ad11033fc6cb455fc,codal-sid,frontend/src/Assets/css/scss/_profile.scss,7,9,2
611c029b243aba8a577b359ad11033fc6cb455fc,codal-sid,frontend/src/Assets/css/scss/_project.scss,21,37,16
611c029b243aba8a577b359ad11033fc6cb455fc,codal-sid,frontend/src/Assets/css/scss/style.css,24,26,2
611c029b243aba8a577b359ad11033fc6cb455fc,codal-sid,frontend/src/Assets/css/scss/style.css.map,1,2,1
611c029b243aba8a577b359ad11033fc6cb455fc,codal-sid,frontend/src/Pages/Projects/ProjectDetails/Component/project.jsx,1,1,0
611c029b243aba8a577b359ad11033fc6cb455fc,codal-sid,frontend/src/Pages/Projects/ProjectList/Component/projectList.jsx,8,14,6
611c029b243aba8a577b359ad11033fc6cb455fc,codal-sid,frontend/src/Pages/Request/EditChangeAllocation/Component/EditAllocation.jsx,5,9,4
611c029b243aba8a577b359ad11033fc6cb455fc,codal-sid,frontend/src/Pages/Request/EditMoveAllocation/Component/EditMoveResource.jsx,4,7,3
611c029b243aba8a577b359ad11033fc6cb455fc,codal-sid,frontend/src/Pages/Request/RequestList/Component/request.jsx,8,12,4
611c029b243aba8a577b359ad11033fc6cb455fc,codal-sid,frontend/src/Pages/Request/RequestResource/Component/EditResource/Component/EditRequest.jsx,2,4,2
611c029b243aba8a577b359ad11033fc6cb455fc,codal-sid,frontend/src/Pages/Request/RequestResource/Component/MoveResourceStep/Component/MoveResource.jsx,2,4,2
611c029b243aba8a577b359ad11033fc6cb455fc,codal-sid,frontend/src/Pages/Request/RequestResource/Component/MoveResourceStep/Component/Step1.jsx,8,11,3
611c029b243aba8a577b359ad11033fc6cb455fc,codal-sid,frontend/src/Pages/Request/RequestResource/Component/MoveResourceStep/Component/Step2.jsx,3,5,2
611c029b243aba8a577b359ad11033fc6cb455fc,codal-sid,frontend/src/Pages/UserProfile/Profile/Component/profile.jsx,58,108,50
fcf009fd08d8a10897f98a06718d775b19d80333,codal-jsojitra,frontend/src/Pages/Request/RequestList/Component/request.jsx,5,7,2
fcf009fd08d8a10897f98a06718d775b19d80333,codal-jsojitra,frontend/src/Pages/UserProfile/Profile/Component/profile.jsx,52,104,52
85c2c8d9528a03c3e4175a22327e4fbe2f18047a,codal-jsojitra,frontend/src/Assets/css/scss/_component.scss,16,16,0
85c2c8d9528a03c3e4175a22327e4fbe2f18047a,codal-jsojitra,frontend/src/Assets/css/scss/_project.scss,21,37,16
85c2c8d9528a03c3e4175a22327e4fbe2f18047a,codal-jsojitra,frontend/src/Assets/css/scss/style.css,19,19,0
85c2c8d9528a03c3e4175a22327e4fbe2f18047a,codal-jsojitra,frontend/src/Assets/css/scss/style.css.map,1,2,1
85c2c8d9528a03c3e4175a22327e4fbe2f18047a,codal-jsojitra,frontend/src/Pages/Projects/ProjectDetails/Component/project.jsx,1,1,0
b5ca7184cd2aa4973f5b80f7816fa328573666f8,codal-jsojitra,frontend/src/Assets/css/scss/_profile.scss,7,9,2
b5ca7184cd2aa4973f5b80f7816fa328573666f8,codal-jsojitra,frontend/src/Assets/css/scss/style.css,5,7,2
b5ca7184cd2aa4973f5b80f7816fa328573666f8,codal-jsojitra,frontend/src/Assets/css/scss/style.css.map,1,2,1
b5ca7184cd2aa4973f5b80f7816fa328573666f8,codal-jsojitra,frontend/src/Pages/Projects/ProjectList/Component/projectList.jsx,8,14,6
b5ca7184cd2aa4973f5b80f7816fa328573666f8,codal-jsojitra,frontend/src/Pages/Request/EditChangeAllocation/Component/EditAllocation.jsx,5,9,4
b5ca7184cd2aa4973f5b80f7816fa328573666f8,codal-jsojitra,frontend/src/Pages/Request/EditMoveAllocation/Component/EditMoveResource.jsx,4,7,3
b5ca7184cd2aa4973f5b80f7816fa328573666f8,codal-jsojitra,frontend/src/Pages/Request/RequestList/Component/request.jsx,3,5,2
b5ca7184cd2aa4973f5b80f7816fa328573666f8,codal-jsojitra,frontend/src/Pages/Request/RequestResource/Component/EditResource/Component/EditRequest.jsx,2,4,2
b5ca7184cd2aa4973f5b80f7816fa328573666f8,codal-jsojitra,frontend/src/Pages/Request/RequestResource/Component/MoveResourceStep/Component/MoveResource.jsx,2,4,2
b5ca7184cd2aa4973f5b80f7816fa328573666f8,codal-jsojitra,frontend/src/Pages/Request/RequestResource/Component/MoveResourceStep/Component/Step1.jsx,8,11,3
b5ca7184cd2aa4973f5b80f7816fa328573666f8,codal-jsojitra,frontend/src/Pages/Request/RequestResource/Component/MoveResourceStep/Component/Step2.jsx,3,5,2
b5ca7184cd2aa4973f5b80f7816fa328573666f8,codal-jsojitra,frontend/src/Pages/UserProfile/Profile/Component/profile.jsx,27,46,19
8a5f64ae8a04be806dd2eb11301a16ab05a6db21,codal-sid,frontend/src/Pages/Request/EditMoveAllocation/Component/EditMoveResource.jsx,26,28,2
8a5f64ae8a04be806dd2eb11301a16ab05a6db21,codal-sid,frontend/src/Pages/Request/RequestResource/Component/EditResource/Component/EditRequest.jsx,8,11,3
8a5f64ae8a04be806dd2eb11301a16ab05a6db21,codal-sid,frontend/src/Pages/Request/RequestResource/Component/MoveResourceStep/Component/MoveResource.jsx,15,17,2
8a5f64ae8a04be806dd2eb11301a16ab05a6db21,codal-sid,frontend/src/Pages/Request/RequestResource/Component/MoveResourceStep/Component/Step1.jsx,17,23,6
8a5f64ae8a04be806dd2eb11301a16ab05a6db21,codal-sid,frontend/src/Pages/Request/RequestResource/Component/MoveResourceStep/Component/Step2.jsx,1,2,1
8a5f64ae8a04be806dd2eb11301a16ab05a6db21,codal-sid,frontend/src/Pages/Request/RequestResource/Component/RequestSubmit.jsx,6,9,3
5dfc42b425d4df4df2dd6547068070a2ad0968f5,codal-jsojitra,frontend/src/Pages/Request/RequestResource/Component/EditResource/Component/EditRequest.jsx,8,11,3
80b9a775ad8dfb1150c804e8c7a68b5a3996e665,codal-jsojitra,frontend/src/Pages/Request/EditMoveAllocation/Component/EditMoveResource.jsx,26,28,2
80b9a775ad8dfb1150c804e8c7a68b5a3996e665,codal-jsojitra,frontend/src/Pages/Request/RequestResource/Component/MoveResourceStep/Component/MoveResource.jsx,15,17,2
80b9a775ad8dfb1150c804e8c7a68b5a3996e665,codal-jsojitra,frontend/src/Pages/Request/RequestResource/Component/MoveResourceStep/Component/Step1.jsx,17,23,6
80b9a775ad8dfb1150c804e8c7a68b5a3996e665,codal-jsojitra,frontend/src/Pages/Request/RequestResource/Component/MoveResourceStep/Component/Step2.jsx,1,2,1
80b9a775ad8dfb1150c804e8c7a68b5a3996e665,codal-jsojitra,frontend/src/Pages/Request/RequestResource/Component/RequestSubmit.jsx,6,9,3
c02d0d89abc93de1be274b9c7713d0d6bcbf9288,codal-sid,backend/rptool/serializers.py,2,4,2
c02d0d89abc93de1be274b9c7713d0d6bcbf9288,codal-sid,backend/rptool/views.py,2,4,2
429c7f4c0fb3e268d80fdc1e4a7a0bc1f76c5e20,codal-sid,backend/rptool/serializers.py,1,2,1
25d0e3d1da87c35edf274c7d8b683df9e054458d,codal-sid,backend/rptool/serializers.py,1,2,1
25d0e3d1da87c35edf274c7d8b683df9e054458d,codal-sid,backend/rptool/views.py,2,4,2
38e52dcefd569e2dc4760e5a292b930ee38d14e4,codal-sid,frontend/src/Assets/css/scss/_requestResource.scss,9,9,0
38e52dcefd569e2dc4760e5a292b930ee38d14e4,codal-sid,frontend/src/Assets/css/scss/style.css,7,7,0
38e52dcefd569e2dc4760e5a292b930ee38d14e4,codal-sid,frontend/src/Assets/css/scss/style.css.map,1,2,1
38e52dcefd569e2dc4760e5a292b930ee38d14e4,codal-sid,frontend/src/Pages/Projects/ProjectList/Component/projectList.jsx,0,1,1
38e52dcefd569e2dc4760e5a292b930ee38d14e4,codal-sid,frontend/src/Pages/Request/EditChangeAllocation/Component/EditAllocation.jsx,90,125,35
38e52dcefd569e2dc4760e5a292b930ee38d14e4,codal-sid,frontend/src/Pages/Request/RequestResource/Component/EditResource/Component/EditRequest.jsx,88,125,37
38e52dcefd569e2dc4760e5a292b930ee38d14e4,codal-sid,frontend/src/Pages/Request/RequestResource/Component/MoveResourceStep/Component/Step1.jsx,22,25,3
38e52dcefd569e2dc4760e5a292b930ee38d14e4,codal-sid,frontend/src/Pages/Request/RequestResource/Component/MoveResourceStep/Component/Step2.jsx,61,82,21
38e52dcefd569e2dc4760e5a292b930ee38d14e4,codal-sid,frontend/src/Pages/Request/RequestResource/Component/MoveResourceStep/Container/index.js,2,4,2
38e52dcefd569e2dc4760e5a292b930ee38d14e4,codal-sid,frontend/src/Pages/Request/RequestResource/Component/RequestSubmit.jsx,22,25,3
38e52dcefd569e2dc4760e5a292b930ee38d14e4,codal-sid,frontend/src/Pages/Request/RequestResource/Container/index.js,2,4,2
38e52dcefd569e2dc4760e5a292b930ee38d14e4,codal-sid,frontend/src/Pages/UserProfile/Profile/Component/profile.jsx,5,10,5
61635771381e34f34acab84740771ad851e17dde,codal-jsojitra,frontend/src/Pages/Request/RequestResource/Component/MoveResourceStep/Component/Step2.jsx,33,51,18
14ec7fcaeabf63c3ad2d142148a4ed2b50667319,codal-jsojitra,frontend/src/Assets/css/scss/_requestResource.scss,9,9,0
14ec7fcaeabf63c3ad2d142148a4ed2b50667319,codal-jsojitra,frontend/src/Assets/css/scss/style.css,7,7,0
14ec7fcaeabf63c3ad2d142148a4ed2b50667319,codal-jsojitra,frontend/src/Assets/css/scss/style.css.map,1,2,1
14ec7fcaeabf63c3ad2d142148a4ed2b50667319,codal-jsojitra,frontend/src/Pages/Request/EditChangeAllocation/Component/EditAllocation.jsx,90,125,35
14ec7fcaeabf63c3ad2d142148a4ed2b50667319,codal-jsojitra,frontend/src/Pages/Request/RequestResource/Component/EditResource/Component/EditRequest.jsx,88,125,37
14ec7fcaeabf63c3ad2d142148a4ed2b50667319,codal-jsojitra,frontend/src/Pages/Request/RequestResource/Component/MoveResourceStep/Component/Step1.jsx,22,25,3
14ec7fcaeabf63c3ad2d142148a4ed2b50667319,codal-jsojitra,frontend/src/Pages/Request/RequestResource/Component/MoveResourceStep/Component/Step2.jsx,29,33,4
14ec7fcaeabf63c3ad2d142148a4ed2b50667319,codal-jsojitra,frontend/src/Pages/Request/RequestResource/Component/MoveResourceStep/Container/index.js,2,4,2
14ec7fcaeabf63c3ad2d142148a4ed2b50667319,codal-jsojitra,frontend/src/Pages/Request/RequestResource/Component/RequestSubmit.jsx,22,25,3
14ec7fcaeabf63c3ad2d142148a4ed2b50667319,codal-jsojitra,frontend/src/Pages/Request/RequestResource/Container/index.js,2,4,2
fba873c4020ca4a6091fc62f29697e54d3fbfc0b,codal-jsojitra,frontend/src/Pages/Projects/ProjectList/Component/projectList.jsx,0,1,1
fba873c4020ca4a6091fc62f29697e54d3fbfc0b,codal-jsojitra,frontend/src/Pages/UserProfile/Profile/Component/profile.jsx,5,10,5
f92c8e109cb8b60eb3966b4e7dace8c01e8ef746,codal-sid,frontend/src/Pages/Projects/ProjectDetails/Component/project.jsx,3,6,3
f92c8e109cb8b60eb3966b4e7dace8c01e8ef746,codal-sid,frontend/src/Pages/Projects/ProjectList/Component/projectList.jsx,14,24,10
f47edd1f5ab3b00a763db4820d23b816659f9567,codal-jsojitra,frontend/src/Pages/Projects/ProjectList/Component/projectList.jsx,12,26,14
f8d222dd8ddc16f59e131298ed6c3573ac4e2e9a,codal-jsojitra,frontend/src/Pages/Projects/ProjectDetails/Component/project.jsx,3,6,3
f8d222dd8ddc16f59e131298ed6c3573ac4e2e9a,codal-jsojitra,frontend/src/Pages/Projects/ProjectList/Component/projectList.jsx,10,14,4
3f76cd7d61e77185a7fe9d95ebf62a14681160f8,codal-sid,frontend/src/Assets/img/user_avatar.png,0,0,0
3f76cd7d61e77185a7fe9d95ebf62a14681160f8,codal-sid,frontend/src/Pages/Projects/ProjectDetails/Component/project.jsx,23,40,17
3f76cd7d61e77185a7fe9d95ebf62a14681160f8,codal-sid,frontend/src/Pages/Request/RequestList/Component/request.jsx,41,46,5
3f76cd7d61e77185a7fe9d95ebf62a14681160f8,codal-sid,frontend/src/Pages/Request/RequestResource/Component/MoveResourceStep/Component/Step1.jsx,4,14,10
3f76cd7d61e77185a7fe9d95ebf62a14681160f8,codal-sid,frontend/src/Pages/UserProfile/Profile/Component/profile.jsx,44,65,21
3f76cd7d61e77185a7fe9d95ebf62a14681160f8,codal-sid,frontend/src/common/nameSorter.js,13,13,0
d1e3ff29e9ee7cb984a4d0a984e7cd623103ea36,codal-sid,backend/rptool/serializers.py,20,41,21
d1e3ff29e9ee7cb984a4d0a984e7cd623103ea36,codal-sid,backend/rptool/views.py,15,16,1
8ac0c5b6f970690929317774067427c6e46f5497,codal-jsojitra,frontend/src/Assets/img/user_avatar.png,0,0,0
8ac0c5b6f970690929317774067427c6e46f5497,codal-jsojitra,frontend/src/Pages/Projects/ProjectDetails/Component/project.jsx,23,40,17
8ac0c5b6f970690929317774067427c6e46f5497,codal-jsojitra,frontend/src/Pages/Request/RequestList/Component/request.jsx,41,46,5
8ac0c5b6f970690929317774067427c6e46f5497,codal-jsojitra,frontend/src/Pages/Request/RequestResource/Component/MoveResourceStep/Component/Step1.jsx,4,14,10
8ac0c5b6f970690929317774067427c6e46f5497,codal-jsojitra,frontend/src/Pages/UserProfile/Profile/Component/profile.jsx,44,65,21
8ac0c5b6f970690929317774067427c6e46f5497,codal-jsojitra,frontend/src/common/nameSorter.js,13,13,0
fa79906b39577f8cac57b55d5b62f38d047283e8,codal-sid,backend/rptool/views.py,0,1,1
b3edcae7328edb8f53da51642bec7a071c283a3e,codal-sid,backend/rptool/serializers.py,20,41,21
b3edcae7328edb8f53da51642bec7a071c283a3e,codal-sid,backend/rptool/views.py,16,17,1
641e70f47505e3820c48b9eeb7be53a5ffe4ec2f,codal-sid,frontend/src/Actions/index.js,1,2,1
641e70f47505e3820c48b9eeb7be53a5ffe4ec2f,codal-sid,frontend/src/Pages/Projects/ProjectDetails/Component/project.jsx,89,139,50
641e70f47505e3820c48b9eeb7be53a5ffe4ec2f,codal-sid,frontend/src/Pages/UserProfile/Profile/Component/profile.jsx,26,41,15
fb11a1d65b8b7e3aeda72236815d0d1094b9d39b,codal-jsojitra,frontend/src/Actions/index.js,1,2,1
fb11a1d65b8b7e3aeda72236815d0d1094b9d39b,codal-jsojitra,frontend/src/Pages/Projects/ProjectDetails/Component/project.jsx,89,139,50
fb11a1d65b8b7e3aeda72236815d0d1094b9d39b,codal-jsojitra,frontend/src/Pages/UserProfile/Profile/Component/profile.jsx,26,41,15
ec61bf46faf0e695bb9a26c413f5623e9a4cd16d,codal-sid,backend/rptool/admin.py,2,4,2
ec61bf46faf0e695bb9a26c413f5623e9a4cd16d,codal-sid,backend/rptool/serializers.py,1,6,5
ec61bf46faf0e695bb9a26c413f5623e9a4cd16d,codal-sid,backend/rptool/signals.py,4,10,6
ec61bf46faf0e695bb9a26c413f5623e9a4cd16d,codal-sid,backend/rptool/views.py,2,3,1
abe7e7099b8bb161f1b769f161ea2ceef7efa4ba,codal-sid,backend/rptool/admin.py,2,4,2
abe7e7099b8bb161f1b769f161ea2ceef7efa4ba,codal-sid,backend/rptool/serializers.py,1,6,5
abe7e7099b8bb161f1b769f161ea2ceef7efa4ba,codal-sid,backend/rptool/signals.py,4,10,6
abe7e7099b8bb161f1b769f161ea2ceef7efa4ba,codal-sid,backend/rptool/views.py,2,3,1
e9092790078a7e7472548534b1483f7f6d1fb600,codal-sid,backend/rptool/admin.py,11,21,10
e9092790078a7e7472548534b1483f7f6d1fb600,codal-sid,backend/rptool/filters.py,5,14,9
e9092790078a7e7472548534b1483f7f6d1fb600,codal-sid,backend/rptool/migrations/0037_auto_20200509_1437.py,24,24,0
e9092790078a7e7472548534b1483f7f6d1fb600,codal-sid,backend/rptool/migrations/0038_project_created_by.py,19,19,0
e9092790078a7e7472548534b1483f7f6d1fb600,codal-sid,backend/rptool/models.py,5,6,1
e9092790078a7e7472548534b1483f7f6d1fb600,codal-sid,backend/rptool/permissions.py,10,10,0
e9092790078a7e7472548534b1483f7f6d1fb600,codal-sid,backend/rptool/serializers.py,271,455,184
e9092790078a7e7472548534b1483f7f6d1fb600,codal-sid,backend/rptool/signals.py,133,309,176
e9092790078a7e7472548534b1483f7f6d1fb600,codal-sid,backend/rptool/tasks.py,17,34,17
e9092790078a7e7472548534b1483f7f6d1fb600,codal-sid,backend/rptool/urls.py,2,3,1
e9092790078a7e7472548534b1483f7f6d1fb600,codal-sid,backend/rptool/views.py,208,317,109
91e8d0781d69001ab5d314ae03ca390f953094bf,codal-sid,frontend/src/Actions/index.js,24,26,2
91e8d0781d69001ab5d314ae03ca390f953094bf,codal-sid,frontend/src/Actions/type.js,2,2,0
91e8d0781d69001ab5d314ae03ca390f953094bf,codal-sid,frontend/src/Pages/Request/RequestResource/Component/AddRequest/AddRequest.jsx,11,18,7
91e8d0781d69001ab5d314ae03ca390f953094bf,codal-sid,frontend/src/Pages/Request/RequestResource/Component/MoveResourceStep/Component/MoveResource.jsx,17,56,39
91e8d0781d69001ab5d314ae03ca390f953094bf,codal-sid,frontend/src/Pages/Request/RequestResource/Component/MoveResourceStep/Component/Step1.jsx,25,41,16
91e8d0781d69001ab5d314ae03ca390f953094bf,codal-sid,frontend/src/Pages/Request/RequestResource/Component/MoveResourceStep/Component/Step2.jsx,20,47,27
91e8d0781d69001ab5d314ae03ca390f953094bf,codal-sid,frontend/src/Pages/Request/RequestResource/Component/MoveResourceStep/Container/index.js,4,6,2
91e8d0781d69001ab5d314ae03ca390f953094bf,codal-sid,frontend/src/Pages/Request/RequestResource/Component/RequestSubmit.jsx,2,2,0
91e8d0781d69001ab5d314ae03ca390f953094bf,codal-sid,frontend/src/Reducers/Request/MoveResourceRequest.js,21,21,0
91e8d0781d69001ab5d314ae03ca390f953094bf,codal-sid,frontend/src/Reducers/index.js,3,5,2
dc113b413a2fce6a278990dcae10c0169347448b,codal-sid,backend/rptool/admin.py,11,21,10
dc113b413a2fce6a278990dcae10c0169347448b,codal-sid,backend/rptool/migrations/0038_project_created_by.py,19,19,0
dc113b413a2fce6a278990dcae10c0169347448b,codal-sid,backend/rptool/models.py,4,4,0
dc113b413a2fce6a278990dcae10c0169347448b,codal-sid,backend/rptool/serializers.py,92,115,23
dc113b413a2fce6a278990dcae10c0169347448b,codal-sid,backend/rptool/signals.py,56,59,3
dc113b413a2fce6a278990dcae10c0169347448b,codal-sid,backend/rptool/tasks.py,17,34,17
dc113b413a2fce6a278990dcae10c0169347448b,codal-sid,backend/rptool/views.py,79,162,83
6d0964d777bbcf198205880c064e4fb2409c4864,codal-jsojitra,frontend/src/Pages/Request/RequestResource/Component/AddRequest/AddRequest.jsx,11,18,7
582c8d73d70e7af68d5239f92d19de4b8f3cac5c,codal-jsojitra,frontend/src/Pages/Request/RequestResource/Component/RequestSubmit.jsx,1,2,1
7ed10500fd34402f822bc2248a190eb3024f87ef,codal-jsojitra,frontend/src/Pages/Request/RequestResource/Component/MoveResourceStep/Component/Step1.jsx,10,17,7
7ed10500fd34402f822bc2248a190eb3024f87ef,codal-jsojitra,frontend/src/Pages/Request/RequestResource/Component/RequestSubmit.jsx,2,2,0
bb25bc95888ee7002fcaeebe240edfbc86475ecb,codal-sid,frontend/src/Pages/Request/RequestResource/Component/MoveResourceStep/Component/Step1.jsx,9,13,4
bb25bc95888ee7002fcaeebe240edfbc86475ecb,codal-sid,frontend/src/Pages/Request/RequestResource/Component/RequestSubmit.jsx,1,2,1
fc6a523e222b8ed6780d85e287ca234a6f508419,codal-jsojitra,frontend/src/common/Config.js,1,3,2
9495535c9deb72932adf1846a526bb8a6814d4a3,codal-jsojitra,frontend/src/Pages/Request/RequestResource/Component/MoveResourceStep/Component/Step1.jsx,1,2,1
c62abf082ba0d05f73ce4e800fcda9775410e623,codal-jsojitra,frontend/src/Pages/Request/RequestResource/Component/MoveResourceStep/Component/Step1.jsx,10,15,5
c62abf082ba0d05f73ce4e800fcda9775410e623,codal-jsojitra,frontend/src/Pages/Request/RequestResource/Component/RequestSubmit.jsx,1,2,1
c62abf082ba0d05f73ce4e800fcda9775410e623,codal-jsojitra,frontend/src/common/Config.js,2,3,1
99381198f7ab5e2a02ff21d6a7712fe866354b98,codal-sid,backend/rptool/filters.py,5,14,9
99381198f7ab5e2a02ff21d6a7712fe866354b98,codal-sid,backend/rptool/migrations/0037_auto_20200509_1437.py,24,24,0
99381198f7ab5e2a02ff21d6a7712fe866354b98,codal-sid,backend/rptool/models.py,1,2,1
99381198f7ab5e2a02ff21d6a7712fe866354b98,codal-sid,backend/rptool/permissions.py,10,10,0
99381198f7ab5e2a02ff21d6a7712fe866354b98,codal-sid,backend/rptool/serializers.py,188,358,170
99381198f7ab5e2a02ff21d6a7712fe866354b98,codal-sid,backend/rptool/signals.py,80,256,176
99381198f7ab5e2a02ff21d6a7712fe866354b98,codal-sid,backend/rptool/urls.py,2,3,1
99381198f7ab5e2a02ff21d6a7712fe866354b98,codal-sid,backend/rptool/views.py,139,175,36
91d5ac32e46faba256485e7d3dcd95c5db579f65,codal-jsojitra,frontend/src/Pages/Request/RequestResource/Component/RequestSubmit.jsx,1,2,1
d39b233817f9e277e4f4a23c6bbaa0f2be9a2310,codal-jsojitra,frontend/src/Pages/Request/RequestResource/Component/MoveResourceStep/Component/MoveResource.jsx,1,2,1
da5a084832052c2b5a126d87072313d860afe797,codal-jsojitra,frontend/src/Pages/Request/RequestResource/Component/MoveResourceStep/Component/MoveResource.jsx,2,6,4
ed95cb15ab52c4e6fc076b55fd4cf89c5c07d986,codal-jsojitra,AfterInstall.sh,24,24,0
ed95cb15ab52c4e6fc076b55fd4cf89c5c07d986,codal-jsojitra,BeforeInstall.sh,3,3,0
ed95cb15ab52c4e6fc076b55fd4cf89c5c07d986,codal-jsojitra,appspec.yml,11,30,19
ed95cb15ab52c4e6fc076b55fd4cf89c5c07d986,codal-jsojitra,backend/mainapp/settings.py,2,2,0
ed95cb15ab52c4e6fc076b55fd4cf89c5c07d986,codal-jsojitra,backend/requirements.txt,1,1,0
ed95cb15ab52c4e6fc076b55fd4cf89c5c07d986,codal-jsojitra,backend/rptool/views.py,34,47,13
ed95cb15ab52c4e6fc076b55fd4cf89c5c07d986,codal-jsojitra,frontend/docker/Dockerfile,3,4,1
ed95cb15ab52c4e6fc076b55fd4cf89c5c07d986,codal-jsojitra,frontend/src/Pages/Projects/EditProject/Component/EditProject.js,2,3,1
ed95cb15ab52c4e6fc076b55fd4cf89c5c07d986,codal-jsojitra,frontend/src/Pages/Request/RequestResource/Component/MoveResourceStep/Component/MoveResource.jsx,2,2,0
49ee6818d6bee702018d6cc66e3cb9719056a564,codal-jsojitra,frontend/src/Actions/index.js,1,3,2
49ee6818d6bee702018d6cc66e3cb9719056a564,codal-jsojitra,frontend/src/Pages/Request/RequestResource/Component/MoveResourceStep/Component/MoveResource.jsx,1,2,1
49ee6818d6bee702018d6cc66e3cb9719056a564,codal-jsojitra,frontend/src/Pages/Request/RequestResource/Component/MoveResourceStep/Component/Step1.jsx,5,13,8
49ee6818d6bee702018d6cc66e3cb9719056a564,codal-jsojitra,frontend/src/Pages/Request/RequestResource/Component/MoveResourceStep/Component/Step2.jsx,8,15,7
49ee6818d6bee702018d6cc66e3cb9719056a564,codal-jsojitra,frontend/src/Pages/Request/RequestResource/Component/MoveResourceStep/Container/index.js,0,1,1
49ee6818d6bee702018d6cc66e3cb9719056a564,codal-jsojitra,frontend/src/Reducers/Request/MoveResourceRequest.js,2,3,1
49ee6818d6bee702018d6cc66e3cb9719056a564,codal-jsojitra,frontend/src/common/Config.js,1,3,2
51a9d3defd75e01c9f6f41633ef9b7fcf6d09e7e,codal-jsojitra,AfterInstall.sh,24,24,0
51a9d3defd75e01c9f6f41633ef9b7fcf6d09e7e,codal-jsojitra,BeforeInstall.sh,3,3,0
51a9d3defd75e01c9f6f41633ef9b7fcf6d09e7e,codal-jsojitra,appspec.yml,11,30,19
51a9d3defd75e01c9f6f41633ef9b7fcf6d09e7e,codal-jsojitra,backend/mainapp/settings.py,2,2,0
51a9d3defd75e01c9f6f41633ef9b7fcf6d09e7e,codal-jsojitra,backend/requirements.txt,1,1,0
51a9d3defd75e01c9f6f41633ef9b7fcf6d09e7e,codal-jsojitra,backend/rptool/views.py,34,47,13
51a9d3defd75e01c9f6f41633ef9b7fcf6d09e7e,codal-jsojitra,frontend/docker/Dockerfile,3,4,1
51a9d3defd75e01c9f6f41633ef9b7fcf6d09e7e,codal-jsojitra,frontend/src/Pages/Projects/EditProject/Component/EditProject.js,2,3,1
51a9d3defd75e01c9f6f41633ef9b7fcf6d09e7e,codal-jsojitra,frontend/src/Pages/Request/RequestResource/Component/MoveResourceStep/Component/MoveResource.jsx,2,2,0
0488cfc45480d3241cc345ee719cd53c21f4c678,codal-jsojitra,frontend/src/Actions/index.js,25,27,2
0488cfc45480d3241cc345ee719cd53c21f4c678,codal-jsojitra,frontend/src/Actions/type.js,2,2,0
0488cfc45480d3241cc345ee719cd53c21f4c678,codal-jsojitra,frontend/src/Pages/Request/RequestResource/Component/MoveResourceStep/Component/MoveResource.jsx,13,61,48
0488cfc45480d3241cc345ee719cd53c21f4c678,codal-jsojitra,frontend/src/Pages/Request/RequestResource/Component/MoveResourceStep/Component/Step1.jsx,18,35,17
0488cfc45480d3241cc345ee719cd53c21f4c678,codal-jsojitra,frontend/src/Pages/Request/RequestResource/Component/MoveResourceStep/Component/Step2.jsx,20,48,28
0488cfc45480d3241cc345ee719cd53c21f4c678,codal-jsojitra,frontend/src/Pages/Request/RequestResource/Component/MoveResourceStep/Container/index.js,4,5,1
0488cfc45480d3241cc345ee719cd53c21f4c678,codal-jsojitra,frontend/src/Reducers/Request/MoveResourceRequest.js,20,20,0
0488cfc45480d3241cc345ee719cd53c21f4c678,codal-jsojitra,frontend/src/Reducers/index.js,3,5,2
0488cfc45480d3241cc345ee719cd53c21f4c678,codal-jsojitra,frontend/src/common/Config.js,2,3,1
81922db3a9db3aed2122ec1bc8e869f79decdc55,codal-jsojitra,frontend/src/Pages/Request/RequestResource/Component/MoveResourceStep/Component/MoveResource.jsx,4,10,6
81922db3a9db3aed2122ec1bc8e869f79decdc55,codal-jsojitra,frontend/src/Pages/Request/RequestResource/Component/MoveResourceStep/Component/Step1.jsx,13,26,13
b59babe3af8b49a84fc91b8273299680e63c5be8,codal-sid,frontend/src/Pages/Projects/EditProject/Component/EditProject.js,2,3,1
15979fbd94dbf1da51a8af39a275a5f61d6e4c57,codal-sid,frontend/src/Assets/css/scss/_profile.scss,1,1,0
15979fbd94dbf1da51a8af39a275a5f61d6e4c57,codal-sid,frontend/src/Assets/css/scss/_requestResource.scss,1,1,0
15979fbd94dbf1da51a8af39a275a5f61d6e4c57,codal-sid,frontend/src/Assets/css/scss/style.css,2,2,0
15979fbd94dbf1da51a8af39a275a5f61d6e4c57,codal-sid,frontend/src/Assets/css/scss/style.css.map,1,2,1
15979fbd94dbf1da51a8af39a275a5f61d6e4c57,codal-sid,frontend/src/Pages/Projects/ProjectList/Component/projectList.jsx,7,16,9
15979fbd94dbf1da51a8af39a275a5f61d6e4c57,codal-sid,frontend/src/Pages/Request/EditMoveAllocation/Component/EditMoveResource.jsx,9,18,9
15979fbd94dbf1da51a8af39a275a5f61d6e4c57,codal-sid,frontend/src/Pages/Request/RequestList/Component/request.jsx,3,6,3
15979fbd94dbf1da51a8af39a275a5f61d6e4c57,codal-sid,frontend/src/Pages/Request/RequestResource/Component/EditResource/Component/EditRequest.jsx,11,15,4
15979fbd94dbf1da51a8af39a275a5f61d6e4c57,codal-sid,frontend/src/Pages/Request/RequestResource/Component/MoveResourceStep/Component/MoveResource.jsx,3,6,3
15979fbd94dbf1da51a8af39a275a5f61d6e4c57,codal-sid,frontend/src/Pages/Request/RequestResource/Component/MoveResourceStep/Component/Step1.jsx,2,2,0
15979fbd94dbf1da51a8af39a275a5f61d6e4c57,codal-sid,frontend/src/Pages/Request/RequestResource/Component/MoveResourceStep/Component/Step2.jsx,1,2,1
15979fbd94dbf1da51a8af39a275a5f61d6e4c57,codal-sid,frontend/src/Pages/Request/RequestResource/Component/RequestSubmit.jsx,1,2,1
52381d2560853350e0a08f9891d37a54a5b675fe,codal-jsojitra,frontend/src/Pages/Request/RequestResource/Component/MoveResourceStep/Component/MoveResource.jsx,2,4,2
c8ceda7754477cf541c8a1206e3f735222c28a0e,codal-jsojitra,frontend/src/Pages/Projects/EditProject/Component/EditProject.js,2,3,1
509285fc7ff93a1ec20728c84e91942581150527,codal-jsojitra,frontend/src/Pages/Request/RequestResource/Component/MoveResourceStep/Component/MoveResource.jsx,2,4,2
509285fc7ff93a1ec20728c84e91942581150527,codal-jsojitra,frontend/src/Pages/Request/RequestResource/Component/MoveResourceStep/Component/Step1.jsx,14,25,11
509285fc7ff93a1ec20728c84e91942581150527,codal-jsojitra,frontend/src/Pages/Request/RequestResource/Component/RequestSubmit.jsx,1,2,1
18bd0a2b7f650bf964f512c8e1728727a248abc4,codal-jsojitra,frontend/src/Pages/Request/RequestResource/Component/MoveResourceStep/Component/MoveResource.jsx,34,53,19
a14fb765496321589946c168e4e4bcc57d7328c5,codal-jsojitra,frontend/src/Pages/Request/RequestResource/Component/MoveResourceStep/Component/MoveResource.jsx,3,6,3
14ba7929f3d773a910baf6d45577e24e4efc1465,codal-jsojitra,frontend/src/Pages/Request/RequestResource/Component/MoveResourceStep/Component/MoveResource.jsx,1,2,1
14ba7929f3d773a910baf6d45577e24e4efc1465,codal-jsojitra,frontend/src/Pages/Request/RequestResource/Component/MoveResourceStep/Component/Step1.jsx,9,19,10
861763b9743b91c23ecf31746e8ff9b01c7cab72,codal-jsojitra,frontend/src/Pages/Request/RequestResource/Component/MoveResourceStep/Component/MoveResource.jsx,4,8,4
861763b9743b91c23ecf31746e8ff9b01c7cab72,codal-jsojitra,frontend/src/Pages/Request/RequestResource/Component/MoveResourceStep/Component/Step1.jsx,10,17,7
861763b9743b91c23ecf31746e8ff9b01c7cab72,codal-jsojitra,frontend/src/Pages/Request/RequestResource/Component/RequestSubmit.jsx,1,2,1
9d90f0d7bef9ee5d70851e04a77b587fa870d24c,codal-jsojitra,frontend/src/Pages/Request/EditMoveAllocation/Component/EditMoveResource.jsx,9,18,9
9d90f0d7bef9ee5d70851e04a77b587fa870d24c,codal-jsojitra,frontend/src/Pages/Request/RequestResource/Component/MoveResourceStep/Component/Step2.jsx,1,2,1
5b01bb9fb484771214dbd5a06f02d470633cd8e2,codal-jsojitra,frontend/src/Pages/Projects/ProjectList/Component/projectList.jsx,2,4,2
5b01bb9fb484771214dbd5a06f02d470633cd8e2,codal-jsojitra,frontend/src/Pages/Request/RequestList/Component/request.jsx,3,6,3
62cbbd015275628004d1bf8a53eb8d4ae91e4906,codal-jsojitra,frontend/src/Assets/css/scss/_profile.scss,1,1,0
62cbbd015275628004d1bf8a53eb8d4ae91e4906,codal-jsojitra,frontend/src/Assets/css/scss/style.css,1,1,0
62cbbd015275628004d1bf8a53eb8d4ae91e4906,codal-jsojitra,frontend/src/Assets/css/scss/style.css.map,1,2,1
62cbbd015275628004d1bf8a53eb8d4ae91e4906,codal-jsojitra,frontend/src/Pages/Projects/ProjectList/Component/projectList.jsx,7,16,9
0e2adfdee84ef4c7a934c9508802364f5467a85f,codal-jsojitra,frontend/src/Assets/css/scss/_requestResource.scss,1,1,0
0e2adfdee84ef4c7a934c9508802364f5467a85f,codal-jsojitra,frontend/src/Assets/css/scss/style.css,1,1,0
0e2adfdee84ef4c7a934c9508802364f5467a85f,codal-jsojitra,frontend/src/Assets/css/scss/style.css.map,1,2,1
0e2adfdee84ef4c7a934c9508802364f5467a85f,codal-jsojitra,frontend/src/Pages/Request/RequestResource/Component/EditResource/Component/EditRequest.jsx,11,15,4
eb563673f61f0ff4950bf07c07257bac855a23fd,codal-sid,frontend/src/Assets/css/scss/_project.scss,2,2,0
eb563673f61f0ff4950bf07c07257bac855a23fd,codal-sid,frontend/src/Assets/css/scss/style.css,9,9,0
eb563673f61f0ff4950bf07c07257bac855a23fd,codal-sid,frontend/src/Assets/css/scss/style.css.map,1,2,1
eb563673f61f0ff4950bf07c07257bac855a23fd,codal-sid,frontend/src/Pages/People/Component/employee.jsx,1,4,3
eb563673f61f0ff4950bf07c07257bac855a23fd,codal-sid,frontend/src/Pages/Request/RequestList/Component/request.jsx,73,94,21
eb563673f61f0ff4950bf07c07257bac855a23fd,codal-sid,frontend/src/Pages/Request/RequestResource/Component/EditResource/Component/EditRequest.jsx,4,7,3
8850d9aa52f376a3cbac45eaa1a361b947d033dc,codal-jsojitra,frontend/src/Pages/Request/RequestList/Component/request.jsx,4,9,5
8850d9aa52f376a3cbac45eaa1a361b947d033dc,codal-jsojitra,frontend/src/Pages/Request/RequestResource/Component/EditResource/Component/EditRequest.jsx,4,7,3
f6d8f07bceb1d2f33c4a7ca1afaec6eb09271754,codal-jsojitra,frontend/src/Assets/css/scss/_project.scss,1,1,0
f6d8f07bceb1d2f33c4a7ca1afaec6eb09271754,codal-jsojitra,frontend/src/Assets/css/scss/style.css,9,9,0
f6d8f07bceb1d2f33c4a7ca1afaec6eb09271754,codal-jsojitra,frontend/src/Assets/css/scss/style.css.map,1,2,1
f6d8f07bceb1d2f33c4a7ca1afaec6eb09271754,codal-jsojitra,frontend/src/Pages/Request/RequestList/Component/request.jsx,57,70,13
17043d564e24b174773d4dca715d78e1cc1e704c,codal-sid,backend/requirements.txt,1,2,1
a8952ab695139005efe0d9491ac78f03cd72b830,codal-sid,backend/requirements.txt,1,2,1
3eba59e25b3b14268a31060ccd15557b51ceb7e0,codal-sid,backend/mainapp/settings.py,2,2,0
3eba59e25b3b14268a31060ccd15557b51ceb7e0,codal-sid,backend/requirements.txt,1,1,0
cbd6d885e2c126d4c8ff882e6bdf9eca1e058617,codal-sid,.gitignore,3,3,0
cbd6d885e2c126d4c8ff882e6bdf9eca1e058617,codal-sid,AfterInstall.sh,24,24,0
cbd6d885e2c126d4c8ff882e6bdf9eca1e058617,codal-sid,BeforeInstall.sh,3,3,0
cbd6d885e2c126d4c8ff882e6bdf9eca1e058617,codal-sid,appspec.yml,11,30,19
cbd6d885e2c126d4c8ff882e6bdf9eca1e058617,codal-sid,backend/.gitignore,1,1,0
cbd6d885e2c126d4c8ff882e6bdf9eca1e058617,codal-sid,backend/account/admin.py,6,10,4
cbd6d885e2c126d4c8ff882e6bdf9eca1e058617,codal-sid,backend/account/exclude_field.py,14,14,0
cbd6d885e2c126d4c8ff882e6bdf9eca1e058617,codal-sid,backend/account/migrations/0018_auto_20200227_0801.py,23,23,0
cbd6d885e2c126d4c8ff882e6bdf9eca1e058617,codal-sid,backend/account/models.py,2,3,1
cbd6d885e2c126d4c8ff882e6bdf9eca1e058617,codal-sid,backend/account/permissions.py,1,2,1
cbd6d885e2c126d4c8ff882e6bdf9eca1e058617,codal-sid,backend/account/serializers.py,25,40,15
cbd6d885e2c126d4c8ff882e6bdf9eca1e058617,codal-sid,backend/account/tasks.py,13,14,1
cbd6d885e2c126d4c8ff882e6bdf9eca1e058617,codal-sid,backend/account/views.py,27,49,22
cbd6d885e2c126d4c8ff882e6bdf9eca1e058617,codal-sid,backend/docker/config/nginx/conf.d/local.conf,7,100,93
cbd6d885e2c126d4c8ff882e6bdf9eca1e058617,codal-sid,backend/fixtures/tag_category.json,34,34,0
cbd6d885e2c126d4c8ff882e6bdf9eca1e058617,codal-sid,backend/mainapp/celery_app.py,23,25,2
cbd6d885e2c126d4c8ff882e6bdf9eca1e058617,codal-sid,backend/mainapp/settings.py,10,14,4
cbd6d885e2c126d4c8ff882e6bdf9eca1e058617,codal-sid,backend/requirements.txt,5,5,0
cbd6d885e2c126d4c8ff882e6bdf9eca1e058617,codal-sid,backend/rptool/admin.py,119,141,22
cbd6d885e2c126d4c8ff882e6bdf9eca1e058617,codal-sid,backend/rptool/filters.py,25,25,0
cbd6d885e2c126d4c8ff882e6bdf9eca1e058617,codal-sid,backend/rptool/helpers.py,8,8,0
cbd6d885e2c126d4c8ff882e6bdf9eca1e058617,codal-sid,backend/rptool/migrations/0006_auto_20200203_0656.py,44,44,0
cbd6d885e2c126d4c8ff882e6bdf9eca1e058617,codal-sid,backend/rptool/migrations/0007_auto_20200203_0707.py,18,18,0
cbd6d885e2c126d4c8ff882e6bdf9eca1e058617,codal-sid,backend/rptool/migrations/0008_auto_20200203_1541.py,29,29,0
cbd6d885e2c126d4c8ff882e6bdf9eca1e058617,codal-sid,backend/rptool/migrations/0008_auto_20200205_0651.py,25,25,0
cbd6d885e2c126d4c8ff882e6bdf9eca1e058617,codal-sid,backend/rptool/migrations/0009_auto_20200204_0910.py,19,19,0
cbd6d885e2c126d4c8ff882e6bdf9eca1e058617,codal-sid,backend/rptool/migrations/0010_merge_20200205_1143.py,14,14,0
cbd6d885e2c126d4c8ff882e6bdf9eca1e058617,codal-sid,backend/rptool/migrations/0011_employee_user_fk.py,21,21,0
cbd6d885e2c126d4c8ff882e6bdf9eca1e058617,codal-sid,backend/rptool/migrations/0012_auto_20200213_0731.py,41,41,0
cbd6d885e2c126d4c8ff882e6bdf9eca1e058617,codal-sid,backend/rptool/migrations/0013_requestresource_duration_hours.py,18,18,0
cbd6d885e2c126d4c8ff882e6bdf9eca1e058617,codal-sid,backend/rptool/migrations/0014_auto_20200224_0653.py,54,54,0
cbd6d885e2c126d4c8ff882e6bdf9eca1e058617,codal-sid,backend/rptool/migrations/0015_employee_employee_email.py,18,18,0
cbd6d885e2c126d4c8ff882e6bdf9eca1e058617,codal-sid,backend/rptool/migrations/0016_auto_20200227_0801.py,18,18,0
cbd6d885e2c126d4c8ff882e6bdf9eca1e058617,codal-sid,backend/rptool/migrations/0017_auto_20200303_0527.py,77,77,0
cbd6d885e2c126d4c8ff882e6bdf9eca1e058617,codal-sid,backend/rptool/migrations/0017_employee_total_allocation.py,18,18,0
cbd6d885e2c126d4c8ff882e6bdf9eca1e058617,codal-sid,backend/rptool/migrations/0018_merge_20200303_1328.py,14,14,0
cbd6d885e2c126d4c8ff882e6bdf9eca1e058617,codal-sid,backend/rptool/migrations/0019_auto_20200304_0550.py,34,34,0
cbd6d885e2c126d4c8ff882e6bdf9eca1e058617,codal-sid,backend/rptool/migrations/0019_tagcategory_category_rank.py,18,18,0
cbd6d885e2c126d4c8ff882e6bdf9eca1e058617,codal-sid,backend/rptool/migrations/0020_auto_20200304_0722.py,23,23,0
cbd6d885e2c126d4c8ff882e6bdf9eca1e058617,codal-sid,backend/rptool/migrations/0021_merge_20200304_1119.py,14,14,0
cbd6d885e2c126d4c8ff882e6bdf9eca1e058617,codal-sid,backend/rptool/migrations/0022_projectcomments_commented_by.py,19,19,0
cbd6d885e2c126d4c8ff882e6bdf9eca1e058617,codal-sid,backend/rptool/migrations/0023_merge_20200312_1404.py,14,14,0
cbd6d885e2c126d4c8ff882e6bdf9eca1e058617,codal-sid,backend/rptool/migrations/0024_auto_20200317_0941.py,34,34,0
cbd6d885e2c126d4c8ff882e6bdf9eca1e058617,codal-sid,backend/rptool/migrations/0025_project_project_key.py,18,18,0
cbd6d885e2c126d4c8ff882e6bdf9eca1e058617,codal-sid,backend/rptool/migrations/0026_auto_20200324_0801.py,49,49,0
cbd6d885e2c126d4c8ff882e6bdf9eca1e058617,codal-sid,backend/rptool/migrations/0027_auto_20200327_1049.py,23,23,0
cbd6d885e2c126d4c8ff882e6bdf9eca1e058617,codal-sid,backend/rptool/migrations/0028_employee_is_future_employee.py,18,18,0
cbd6d885e2c126d4c8ff882e6bdf9eca1e058617,codal-sid,backend/rptool/migrations/0029_auto_20200406_1328.py,23,23,0
cbd6d885e2c126d4c8ff882e6bdf9eca1e058617,codal-sid,backend/rptool/migrations/0030_employeeproject_temp_end_date.py,18,18,0
cbd6d885e2c126d4c8ff882e6bdf9eca1e058617,codal-sid,backend/rptool/migrations/0031_jiratimesheetcredentials.py,27,27,0
cbd6d885e2c126d4c8ff882e6bdf9eca1e058617,codal-sid,backend/rptool/migrations/0032_employee_jira_account_id.py,18,18,0
cbd6d885e2c126d4c8ff882e6bdf9eca1e058617,codal-sid,backend/rptool/migrations/0033_jiratimesheetcredentials_access_token.py,18,18,0
cbd6d885e2c126d4c8ff882e6bdf9eca1e058617,codal-sid,backend/rptool/migrations/0034_employee_report_to.py,19,19,0
cbd6d885e2c126d4c8ff882e6bdf9eca1e058617,codal-sid,backend/rptool/migrations/0035_auto_20200421_1302.py,34,34,0
cbd6d885e2c126d4c8ff882e6bdf9eca1e058617,codal-sid,backend/rptool/migrations/0036_employeejiraaccount.py,25,25,0
cbd6d885e2c126d4c8ff882e6bdf9eca1e058617,codal-sid,backend/rptool/models.py,212,212,0
cbd6d885e2c126d4c8ff882e6bdf9eca1e058617,codal-sid,backend/rptool/permissions.py,107,119,12
cbd6d885e2c126d4c8ff882e6bdf9eca1e058617,codal-sid,backend/rptool/serializers.py,881,902,21
cbd6d885e2c126d4c8ff882e6bdf9eca1e058617,codal-sid,backend/rptool/signals.py,247,250,3
cbd6d885e2c126d4c8ff882e6bdf9eca1e058617,codal-sid,backend/rptool/swagger_fields.py,530,533,3
cbd6d885e2c126d4c8ff882e6bdf9eca1e058617,codal-sid,backend/rptool/tasks.py,275,275,0
cbd6d885e2c126d4c8ff882e6bdf9eca1e058617,codal-sid,backend/rptool/urls.py,35,43,8
cbd6d885e2c126d4c8ff882e6bdf9eca1e058617,codal-sid,backend/rptool/views.py,750,793,43
cbd6d885e2c126d4c8ff882e6bdf9eca1e058617,codal-sid,docker-compose.yml,12,82,70
cbd6d885e2c126d4c8ff882e6bdf9eca1e058617,codal-sid,docker-compose.yml.bak,167,167,0
cbd6d885e2c126d4c8ff882e6bdf9eca1e058617,codal-sid,frontend/docker/Dockerfile,15,18,3
cbd6d885e2c126d4c8ff882e6bdf9eca1e058617,codal-sid,frontend/package-lock.json,4137,4249,112
cbd6d885e2c126d4c8ff882e6bdf9eca1e058617,codal-sid,frontend/package.json,14,14,0
cbd6d885e2c126d4c8ff882e6bdf9eca1e058617,codal-sid,frontend/src/Actions/index.js,1210,1244,34
cbd6d885e2c126d4c8ff882e6bdf9eca1e058617,codal-sid,frontend/src/Actions/type.js,175,175,0
cbd6d885e2c126d4c8ff882e6bdf9eca1e058617,codal-sid,frontend/src/App.js,32,43,11
cbd6d885e2c126d4c8ff882e6bdf9eca1e058617,codal-sid,frontend/src/Assets/css/scss/_auth.scss,88,88,0
cbd6d885e2c126d4c8ff882e6bdf9eca1e058617,codal-sid,frontend/src/Assets/css/scss/_component.scss,251,264,13
cbd6d885e2c126d4c8ff882e6bdf9eca1e058617,codal-sid,frontend/src/Assets/css/scss/_custom.scss,5,5,0
cbd6d885e2c126d4c8ff882e6bdf9eca1e058617,codal-sid,frontend/src/Assets/css/scss/_header.scss,79,83,4
cbd6d885e2c126d4c8ff882e6bdf9eca1e058617,codal-sid,frontend/src/Assets/css/scss/_layout.scss,167,168,1
cbd6d885e2c126d4c8ff882e6bdf9eca1e058617,codal-sid,frontend/src/Assets/css/scss/_orgnation.scss,85,85,0
cbd6d885e2c126d4c8ff882e6bdf9eca1e058617,codal-sid,frontend/src/Assets/css/scss/_profile.scss,344,389,45
cbd6d885e2c126d4c8ff882e6bdf9eca1e058617,codal-sid,frontend/src/Assets/css/scss/_project.scss,327,327,0
cbd6d885e2c126d4c8ff882e6bdf9eca1e058617,codal-sid,frontend/src/Assets/css/scss/_requestListing.scss,329,329,0
cbd6d885e2c126d4c8ff882e6bdf9eca1e058617,codal-sid,frontend/src/Assets/css/scss/_requestResource.scss,1547,1547,0
cbd6d885e2c126d4c8ff882e6bdf9eca1e058617,codal-sid,frontend/src/Assets/css/scss/_table.scss,256,361,105
cbd6d885e2c126d4c8ff882e6bdf9eca1e058617,codal-sid,frontend/src/Assets/css/scss/style.css,3096,3259,163
cbd6d885e2c126d4c8ff882e6bdf9eca1e058617,codal-sid,frontend/src/Assets/css/scss/style.css.map,1,2,1
cbd6d885e2c126d4c8ff882e6bdf9eca1e058617,codal-sid,frontend/src/Assets/css/scss/style.scss,6,6,0
cbd6d885e2c126d4c8ff882e6bdf9eca1e058617,codal-sid,frontend/src/Assets/img/login_bg.png,0,0,0
cbd6d885e2c126d4c8ff882e6bdf9eca1e058617,codal-sid,frontend/src/Assets/img/user.svg,86,86,0
cbd6d885e2c126d4c8ff882e6bdf9eca1e058617,codal-sid,frontend/src/Pages/Auth/Component/login.jsx,22,34,12
cbd6d885e2c126d4c8ff882e6bdf9eca1e058617,codal-sid,frontend/src/Pages/Common/Component/404.jsx,20,20,0
cbd6d885e2c126d4c8ff882e6bdf9eca1e058617,codal-sid,frontend/src/Pages/Common/Component/Header.jsx,122,189,67
cbd6d885e2c126d4c8ff882e6bdf9eca1e058617,codal-sid,frontend/src/Pages/Organization/Component/Organization.jsx,219,219,0
cbd6d885e2c126d4c8ff882e6bdf9eca1e058617,codal-sid,frontend/src/Pages/Organization/Container/index.js,30,30,0
cbd6d885e2c126d4c8ff882e6bdf9eca1e058617,codal-sid,frontend/src/Pages/People/Component/employee.jsx,449,534,85
cbd6d885e2c126d4c8ff882e6bdf9eca1e058617,codal-sid,frontend/src/Pages/People/Component/people.jsx,9,20,11
cbd6d885e2c126d4c8ff882e6bdf9eca1e058617,codal-sid,frontend/src/Pages/People/Component/upcoming.jsx,464,575,111
cbd6d885e2c126d4c8ff882e6bdf9eca1e058617,codal-sid,frontend/src/Pages/People/Container/index.js,21,30,9
cbd6d885e2c126d4c8ff882e6bdf9eca1e058617,codal-sid,frontend/src/Pages/Projects/AddProject/Component/addProject.jsx,625,625,0
cbd6d885e2c126d4c8ff882e6bdf9eca1e058617,codal-sid,frontend/src/Pages/Projects/AddProject/Container/index.js,36,36,0
cbd6d885e2c126d4c8ff882e6bdf9eca1e058617,codal-sid,frontend/src/Pages/Projects/EditProject/Component/EditProject.js,361,361,0
cbd6d885e2c126d4c8ff882e6bdf9eca1e058617,codal-sid,frontend/src/Pages/Projects/EditProject/Container/index.js,37,37,0
cbd6d885e2c126d4c8ff882e6bdf9eca1e058617,codal-sid,frontend/src/Pages/Projects/ProjectDetails/Component/project.jsx,724,1035,311
cbd6d885e2c126d4c8ff882e6bdf9eca1e058617,codal-sid,frontend/src/Pages/Projects/ProjectDetails/Container/index.js,43,46,3
cbd6d885e2c126d4c8ff882e6bdf9eca1e058617,codal-sid,frontend/src/Pages/Projects/ProjectList/Component/projectList.jsx,465,818,353
cbd6d885e2c126d4c8ff882e6bdf9eca1e058617,codal-sid,frontend/src/Pages/Projects/ProjectList/Container/index.js,15,17,2
cbd6d885e2c126d4c8ff882e6bdf9eca1e058617,codal-sid,frontend/src/Pages/Request/Component/request.jsx,0,238,238
cbd6d885e2c126d4c8ff882e6bdf9eca1e058617,codal-sid,frontend/src/Pages/Request/Container/index.js,0,19,19
cbd6d885e2c126d4c8ff882e6bdf9eca1e058617,codal-sid,frontend/src/Pages/Request/EditChangeAllocation/Component/EditAllocation.jsx,589,589,0
cbd6d885e2c126d4c8ff882e6bdf9eca1e058617,codal-sid,frontend/src/Pages/Request/EditChangeAllocation/Container/index.js,29,29,0
cbd6d885e2c126d4c8ff882e6bdf9eca1e058617,codal-sid,frontend/src/Pages/Request/EditMoveAllocation/Component/EditMoveResource.jsx,579,579,0
cbd6d885e2c126d4c8ff882e6bdf9eca1e058617,codal-sid,frontend/src/Pages/Request/EditMoveAllocation/Conatiner/index.js,29,29,0
cbd6d885e2c126d4c8ff882e6bdf9eca1e058617,codal-sid,frontend/src/Pages/Request/EditRequest/Component/EditResource.jsx,735,735,0
cbd6d885e2c126d4c8ff882e6bdf9eca1e058617,codal-sid,frontend/src/Pages/Request/EditRequest/Container/index.js,45,45,0
cbd6d885e2c126d4c8ff882e6bdf9eca1e058617,codal-sid,frontend/src/Pages/Request/RequestList/Component/request.jsx,0,0,0
cbd6d885e2c126d4c8ff882e6bdf9eca1e058617,codal-sid,frontend/src/Pages/Request/RequestList/Container/index.js,55,55,0
cbd6d885e2c126d4c8ff882e6bdf9eca1e058617,codal-sid,frontend/src/Pages/Request/RequestResource/Component/AddRequest/AddRequest.jsx,1045,1045,0
cbd6d885e2c126d4c8ff882e6bdf9eca1e058617,codal-sid,frontend/src/Pages/Request/RequestResource/Component/EditResource/Component/EditRequest.jsx,617,617,0
cbd6d885e2c126d4c8ff882e6bdf9eca1e058617,codal-sid,frontend/src/Pages/Request/RequestResource/Component/EditResource/Container/index.js,31,31,0
cbd6d885e2c126d4c8ff882e6bdf9eca1e058617,codal-sid,frontend/src/Pages/Request/RequestResource/Component/MoveResourceStep/Component/MoveResource.jsx,153,153,0
cbd6d885e2c126d4c8ff882e6bdf9eca1e058617,codal-sid,frontend/src/Pages/Request/RequestResource/Component/MoveResourceStep/Component/Step1.jsx,358,358,0
cbd6d885e2c126d4c8ff882e6bdf9eca1e058617,codal-sid,frontend/src/Pages/Request/RequestResource/Component/MoveResourceStep/Component/Step2.jsx,375,375,0
cbd6d885e2c126d4c8ff882e6bdf9eca1e058617,codal-sid,frontend/src/Pages/Request/RequestResource/Component/MoveResourceStep/Container/index.js,29,29,0
cbd6d885e2c126d4c8ff882e6bdf9eca1e058617,codal-sid,frontend/src/Pages/Request/RequestResource/Component/RequestSubmit.jsx,451,451,0
cbd6d885e2c126d4c8ff882e6bdf9eca1e058617,codal-sid,frontend/src/Pages/Request/RequestResource/Container/index.js,57,57,0
cbd6d885e2c126d4c8ff882e6bdf9eca1e058617,codal-sid,frontend/src/Pages/UserProfile/Component/profile.jsx,0,435,435
cbd6d885e2c126d4c8ff882e6bdf9eca1e058617,codal-sid,frontend/src/Pages/UserProfile/Container/index.js,0,19,19
cbd6d885e2c126d4c8ff882e6bdf9eca1e058617,codal-sid,frontend/src/Pages/UserProfile/Edit/Component/EditProfile.jsx,325,325,0
cbd6d885e2c126d4c8ff882e6bdf9eca1e058617,codal-sid,frontend/src/Pages/UserProfile/Edit/Container/index.js,39,39,0
cbd6d885e2c126d4c8ff882e6bdf9eca1e058617,codal-sid,frontend/src/Pages/UserProfile/Profile/Component/profile.jsx,775,775,0
cbd6d885e2c126d4c8ff882e6bdf9eca1e058617,codal-sid,frontend/src/Pages/UserProfile/Profile/Container/index.js,46,46,0
cbd6d885e2c126d4c8ff882e6bdf9eca1e058617,codal-sid,frontend/src/Reducers/Employee/ExportEmployee.js,20,20,0
cbd6d885e2c126d4c8ff882e6bdf9eca1e058617,codal-sid,frontend/src/Reducers/Employee/UpcomingEmployee.js,20,20,0
cbd6d885e2c126d4c8ff882e6bdf9eca1e058617,codal-sid,frontend/src/Reducers/Organization/OrgChart.js,17,17,0
cbd6d885e2c126d4c8ff882e6bdf9eca1e058617,codal-sid,frontend/src/Reducers/Project/AddJiraAccount.js,19,19,0
cbd6d885e2c126d4c8ff882e6bdf9eca1e058617,codal-sid,frontend/src/Reducers/Project/CreateProject.js,20,20,0
cbd6d885e2c126d4c8ff882e6bdf9eca1e058617,codal-sid,frontend/src/Reducers/Project/GetAllProject.js,20,20,0
cbd6d885e2c126d4c8ff882e6bdf9eca1e058617,codal-sid,frontend/src/Reducers/Project/GetJiraAccounts.js,17,17,0
cbd6d885e2c126d4c8ff882e6bdf9eca1e058617,codal-sid,frontend/src/Reducers/Project/GetJiraLog.js,19,19,0
cbd6d885e2c126d4c8ff882e6bdf9eca1e058617,codal-sid,frontend/src/Reducers/Project/GetJiraProjects.js,20,20,0
cbd6d885e2c126d4c8ff882e6bdf9eca1e058617,codal-sid,frontend/src/Reducers/Project/GetProjectByID.js,20,20,0
cbd6d885e2c126d4c8ff882e6bdf9eca1e058617,codal-sid,frontend/src/Reducers/Project/GetProjectComments.js,19,19,0
cbd6d885e2c126d4c8ff882e6bdf9eca1e058617,codal-sid,frontend/src/Reducers/Project/GetProjectRequest.js,19,19,0
cbd6d885e2c126d4c8ff882e6bdf9eca1e058617,codal-sid,frontend/src/Reducers/Project/GetProjectTeam.js,19,19,0
cbd6d885e2c126d4c8ff882e6bdf9eca1e058617,codal-sid,frontend/src/Reducers/Project/GetRequestCount.js,21,21,0
cbd6d885e2c126d4c8ff882e6bdf9eca1e058617,codal-sid,frontend/src/Reducers/Project/GetTimeOffByProject.js,20,20,0
cbd6d885e2c126d4c8ff882e6bdf9eca1e058617,codal-sid,frontend/src/Reducers/Project/PostProjectComment.js,19,19,0
cbd6d885e2c126d4c8ff882e6bdf9eca1e058617,codal-sid,frontend/src/Reducers/Project/UpdateProjectById.js,19,19,0
cbd6d885e2c126d4c8ff882e6bdf9eca1e058617,codal-sid,frontend/src/Reducers/Request/GetApproveEmpProject.js,20,20,0
cbd6d885e2c126d4c8ff882e6bdf9eca1e058617,codal-sid,frontend/src/Reducers/Request/GetEditRequestEmployee.js,20,20,0
cbd6d885e2c126d4c8ff882e6bdf9eca1e058617,codal-sid,frontend/src/Reducers/Request/GetEmployeebyProject.js,21,21,0
cbd6d885e2c126d4c8ff882e6bdf9eca1e058617,codal-sid,frontend/src/Reducers/Resource/ApproveReject.js,21,21,0
cbd6d885e2c126d4c8ff882e6bdf9eca1e058617,codal-sid,frontend/src/Reducers/Resource/ExpandRequest.js,20,20,0
cbd6d885e2c126d4c8ff882e6bdf9eca1e058617,codal-sid,frontend/src/Reducers/Resource/RequestCommentById.js,20,20,0
cbd6d885e2c126d4c8ff882e6bdf9eca1e058617,codal-sid,frontend/src/Reducers/Resource/ResourceInfo.js,20,20,0
cbd6d885e2c126d4c8ff882e6bdf9eca1e058617,codal-sid,frontend/src/Reducers/ResourceComment.js,20,20,0
cbd6d885e2c126d4c8ff882e6bdf9eca1e058617,codal-sid,frontend/src/Reducers/ResourceListing.js,19,19,0
cbd6d885e2c126d4c8ff882e6bdf9eca1e058617,codal-sid,frontend/src/Reducers/ResourceRequest.js,20,20,0
cbd6d885e2c126d4c8ff882e6bdf9eca1e058617,codal-sid,frontend/src/Reducers/ResourceUpdate.js,19,19,0
cbd6d885e2c126d4c8ff882e6bdf9eca1e058617,codal-sid,frontend/src/Reducers/User/GetProjectByHours.js,21,21,0
cbd6d885e2c126d4c8ff882e6bdf9eca1e058617,codal-sid,frontend/src/Reducers/User/GetProjectTeamCount.js,21,21,0
cbd6d885e2c126d4c8ff882e6bdf9eca1e058617,codal-sid,frontend/src/Reducers/User/GetReportTo.js,20,20,0
cbd6d885e2c126d4c8ff882e6bdf9eca1e058617,codal-sid,frontend/src/Reducers/User/GetTimeoff.js,21,21,0
cbd6d885e2c126d4c8ff882e6bdf9eca1e058617,codal-sid,frontend/src/Reducers/User/GetUSerProject.js,19,19,0
cbd6d885e2c126d4c8ff882e6bdf9eca1e058617,codal-sid,frontend/src/Reducers/User/GetUserComment.js,19,19,0
cbd6d885e2c126d4c8ff882e6bdf9eca1e058617,codal-sid,frontend/src/Reducers/User/GetUserProfile.js,19,19,0
cbd6d885e2c126d4c8ff882e6bdf9eca1e058617,codal-sid,frontend/src/Reducers/User/GetUserrequest.js,19,19,0
cbd6d885e2c126d4c8ff882e6bdf9eca1e058617,codal-sid,frontend/src/Reducers/User/UpdateUserProfile.js,19,19,0
cbd6d885e2c126d4c8ff882e6bdf9eca1e058617,codal-sid,frontend/src/Reducers/auth.js,1,2,1
cbd6d885e2c126d4c8ff882e6bdf9eca1e058617,codal-sid,frontend/src/Reducers/empLocationType.js,2,5,3
cbd6d885e2c126d4c8ff882e6bdf9eca1e058617,codal-sid,frontend/src/Reducers/employeeProject.js,3,8,5
cbd6d885e2c126d4c8ff882e6bdf9eca1e058617,codal-sid,frontend/src/Reducers/getEmployee.js,3,6,3
cbd6d885e2c126d4c8ff882e6bdf9eca1e058617,codal-sid,frontend/src/Reducers/getRequestById.js,19,19,0
cbd6d885e2c126d4c8ff882e6bdf9eca1e058617,codal-sid,frontend/src/Reducers/getTag.js,5,12,7
cbd6d885e2c126d4c8ff882e6bdf9eca1e058617,codal-sid,frontend/src/Reducers/index.js,84,90,6
cbd6d885e2c126d4c8ff882e6bdf9eca1e058617,codal-sid,frontend/src/Reducers/mainResource.js,22,22,0
cbd6d885e2c126d4c8ff882e6bdf9eca1e058617,codal-sid,frontend/src/common/Config.js,4,10,6
cbd6d885e2c126d4c8ff882e6bdf9eca1e058617,codal-sid,frontend/src/common/PrivateRoute.js,0,14,14
cbd6d885e2c126d4c8ff882e6bdf9eca1e058617,codal-sid,frontend/src/common/RoleServices.js,42,42,0
cbd6d885e2c126d4c8ff882e6bdf9eca1e058617,codal-sid,frontend/src/common/googleConfig.js,1,2,1
cbd6d885e2c126d4c8ff882e6bdf9eca1e058617,codal-sid,frontend/src/index.js,1,2,1
cbd6d885e2c126d4c8ff882e6bdf9eca1e058617,codal-sid,package-lock.json,159,159,0
3dd854dfd00d0146ef5b31089537baac4f36e7d1,sshaikhcodal,backend/mainapp/settings.py,2,2,0
3dd854dfd00d0146ef5b31089537baac4f36e7d1,sshaikhcodal,backend/requirements.txt,1,1,0
ba394399f1c804f8833ec2f0bbbc7ac3805a8fa5,codal-jsojitra,frontend/src/Assets/css/scss/_project.scss,1,1,0
ba394399f1c804f8833ec2f0bbbc7ac3805a8fa5,codal-jsojitra,frontend/src/Pages/People/Component/employee.jsx,1,4,3
ba394399f1c804f8833ec2f0bbbc7ac3805a8fa5,codal-jsojitra,frontend/src/Pages/Request/RequestList/Component/request.jsx,21,33,12
a26f27d07db1b0fd0cdfdac5185c33eafa8844c0,codal-sid,frontend/package-lock.json,241,253,12
a26f27d07db1b0fd0cdfdac5185c33eafa8844c0,codal-sid,frontend/package.json,1,1,0
a26f27d07db1b0fd0cdfdac5185c33eafa8844c0,codal-sid,frontend/src/Assets/css/scss/_component.scss,9,9,0
a26f27d07db1b0fd0cdfdac5185c33eafa8844c0,codal-sid,frontend/src/Assets/css/scss/_profile.scss,9,9,0
a26f27d07db1b0fd0cdfdac5185c33eafa8844c0,codal-sid,frontend/src/Assets/css/scss/style.css,9,9,0
a26f27d07db1b0fd0cdfdac5185c33eafa8844c0,codal-sid,frontend/src/Assets/css/scss/style.css.map,1,2,1
a26f27d07db1b0fd0cdfdac5185c33eafa8844c0,codal-sid,frontend/src/Pages/Projects/ProjectDetails/Component/project.jsx,10,18,8
a26f27d07db1b0fd0cdfdac5185c33eafa8844c0,codal-sid,frontend/src/Pages/Projects/ProjectList/Component/projectList.jsx,25,36,11
a26f27d07db1b0fd0cdfdac5185c33eafa8844c0,codal-sid,frontend/src/Pages/Request/RequestList/Component/request.jsx,23,39,16
53a171a3aa7da8291c847c4729a47221d425ad68,codal-jsojitra,frontend/package-lock.json,241,253,12
53a171a3aa7da8291c847c4729a47221d425ad68,codal-jsojitra,frontend/package.json,1,1,0
53a171a3aa7da8291c847c4729a47221d425ad68,codal-jsojitra,frontend/src/Assets/css/scss/_component.scss,9,9,0
53a171a3aa7da8291c847c4729a47221d425ad68,codal-jsojitra,frontend/src/Assets/css/scss/_profile.scss,9,9,0
53a171a3aa7da8291c847c4729a47221d425ad68,codal-jsojitra,frontend/src/Assets/css/scss/style.css,9,9,0
53a171a3aa7da8291c847c4729a47221d425ad68,codal-jsojitra,frontend/src/Assets/css/scss/style.css.map,1,2,1
53a171a3aa7da8291c847c4729a47221d425ad68,codal-jsojitra,frontend/src/Pages/Projects/ProjectDetails/Component/project.jsx,10,18,8
53a171a3aa7da8291c847c4729a47221d425ad68,codal-jsojitra,frontend/src/Pages/Projects/ProjectList/Component/projectList.jsx,25,36,11
53a171a3aa7da8291c847c4729a47221d425ad68,codal-jsojitra,frontend/src/Pages/Request/RequestList/Component/request.jsx,23,39,16
1fe897be2826c60e413c97d47182485294c9b2c5,codal-sid,frontend/src/Assets/css/scss/_component.scss,5,5,0
1fe897be2826c60e413c97d47182485294c9b2c5,codal-sid,frontend/src/Assets/css/scss/style.css,6,6,0
1fe897be2826c60e413c97d47182485294c9b2c5,codal-sid,frontend/src/Assets/css/scss/style.css.map,1,2,1
1fe897be2826c60e413c97d47182485294c9b2c5,codal-sid,frontend/src/Pages/Projects/ProjectList/Component/projectList.jsx,20,37,17
1fe897be2826c60e413c97d47182485294c9b2c5,codal-sid,frontend/src/Pages/Request/EditChangeAllocation/Component/EditAllocation.jsx,19,36,17
1fe897be2826c60e413c97d47182485294c9b2c5,codal-sid,frontend/src/Pages/Request/EditMoveAllocation/Component/EditMoveResource.jsx,11,22,11
1fe897be2826c60e413c97d47182485294c9b2c5,codal-sid,frontend/src/Pages/Request/RequestList/Component/request.jsx,55,80,25
1fe897be2826c60e413c97d47182485294c9b2c5,codal-sid,frontend/src/Pages/Request/RequestResource/Component/EditResource/Component/EditRequest.jsx,11,22,11
1fe897be2826c60e413c97d47182485294c9b2c5,codal-sid,frontend/src/Pages/Request/RequestResource/Component/MoveResourceStep/Component/MoveResource.jsx,1,2,1
1fe897be2826c60e413c97d47182485294c9b2c5,codal-sid,frontend/src/Pages/Request/RequestResource/Component/MoveResourceStep/Component/Step1.jsx,2,2,0
1fe897be2826c60e413c97d47182485294c9b2c5,codal-sid,frontend/src/Pages/Request/RequestResource/Component/MoveResourceStep/Component/Step2.jsx,11,21,10
1fe897be2826c60e413c97d47182485294c9b2c5,codal-sid,frontend/src/Pages/UserProfile/Edit/Component/EditProfile.jsx,25,29,4
1fe897be2826c60e413c97d47182485294c9b2c5,codal-sid,frontend/src/index.js,1,2,1
d2e098f1311d7d134bcc96f2e20c886009c40808,codal-jsojitra,frontend/src/Assets/css/scss/_component.scss,5,5,0
d2e098f1311d7d134bcc96f2e20c886009c40808,codal-jsojitra,frontend/src/Assets/css/scss/style.css,6,6,0
d2e098f1311d7d134bcc96f2e20c886009c40808,codal-jsojitra,frontend/src/Assets/css/scss/style.css.map,1,2,1
d2e098f1311d7d134bcc96f2e20c886009c40808,codal-jsojitra,frontend/src/Pages/Projects/ProjectList/Component/projectList.jsx,20,37,17
d2e098f1311d7d134bcc96f2e20c886009c40808,codal-jsojitra,frontend/src/Pages/Request/EditChangeAllocation/Component/EditAllocation.jsx,19,36,17
d2e098f1311d7d134bcc96f2e20c886009c40808,codal-jsojitra,frontend/src/Pages/Request/EditMoveAllocation/Component/EditMoveResource.jsx,11,22,11
d2e098f1311d7d134bcc96f2e20c886009c40808,codal-jsojitra,frontend/src/Pages/Request/RequestList/Component/request.jsx,55,80,25
d2e098f1311d7d134bcc96f2e20c886009c40808,codal-jsojitra,frontend/src/Pages/Request/RequestResource/Component/EditResource/Component/EditRequest.jsx,11,22,11
d2e098f1311d7d134bcc96f2e20c886009c40808,codal-jsojitra,frontend/src/Pages/Request/RequestResource/Component/MoveResourceStep/Component/MoveResource.jsx,1,2,1
d2e098f1311d7d134bcc96f2e20c886009c40808,codal-jsojitra,frontend/src/Pages/Request/RequestResource/Component/MoveResourceStep/Component/Step1.jsx,2,2,0
d2e098f1311d7d134bcc96f2e20c886009c40808,codal-jsojitra,frontend/src/Pages/Request/RequestResource/Component/MoveResourceStep/Component/Step2.jsx,11,21,10
d2e098f1311d7d134bcc96f2e20c886009c40808,codal-jsojitra,frontend/src/Pages/UserProfile/Edit/Component/EditProfile.jsx,25,29,4
d2e098f1311d7d134bcc96f2e20c886009c40808,codal-jsojitra,frontend/src/index.js,1,2,1
4d55e596420a06d9912d836b292cfb3c5ba71199,codal-devops,frontend/docker/Dockerfile,3,4,1
3565cc906b3954b43fd2b757c2a7608f483841b8,codal-sid,backend/rptool/views.py,6,6,0
d2c9c182b290cdf80cd4137d360ae31c8be85525,codal-devops,appspec.yml,1,2,1
955239dd35787c6df1f75dea10a0218dfb51495f,codal-devops,AfterInstall.sh,0,1,1
e820543854f26a9c5375f6d54ad74120b836fbac,codal-devops,AfterInstall.sh,0,2,2
8a12f550dc40816bd1a8d371d04d45611e2e9791,codal-devops,appspec.yml,1,2,1
40c70bf00a5e9641a958b0b7e1836929222bd0ea,codal-devops,appspec.yml,4,8,4
240af59b8e6a057ed249bb66365bde39e18b073c,codal-devops,AfterInstall.sh,2,2,0
79bc18590a481a86135ab1ddc9a42840449a440c,codal-devops,appspec.yml,5,10,5
a89c79fff13a7dcaeda3acd4fd18cb8180445981,codal-devops,appspec.yml,8,16,8
c06d192264ddac3c159b9da2e3aec199f62a93bb,codal-devops,appspec.yml,0,4,4
e55349bfe13881484fad1bee4f0cd5fd6969022d,codal-devops,AfterInstall.sh,10,17,7
49fbccf240588313a990394ecaad9f8644e62094,codal-devops,BeforeInstall.sh,1,2,1
58f47c7182cfd033fd415af961724c9122f6f185,codal-ayush,BeforeInstall.sh,3,3,0
58f47c7182cfd033fd415af961724c9122f6f185,codal-ayush,appspec.yml,5,5,0
3dec2dbce52eae308199a040f77adf535843d4c8,codal-devops,AfterInstall.sh,3,3,0
5f46461c6364449eff4a20545f8066cac5e3d0d1,codal-devops,appspec.yml,8,33,25
913ccc4900f8bf579225c30747e6d24a51ba4f5d,codal-devops,appspec.yml,4,8,4
7f5f5064f0be0a953f8c9fbc89f6dfb315b18bbc,codal-devops,AfterInstall.sh,2,2,0
5ac09d928b6c3221a05e35fb9c6777f7c1775b48,codal-ayush,AfterInstall.sh,2,4,2
5ac09d928b6c3221a05e35fb9c6777f7c1775b48,codal-ayush,appspec.yml,1,2,1
3d391462e29123bab9870045a0e963edb1e58385,codal-ayush,AfterInstall.sh,2,4,2
3d391462e29123bab9870045a0e963edb1e58385,codal-ayush,appspec.yml,1,2,1
404b21a37090843c1da0d4e24a405c633df02729,codal-sid,frontend/src/Pages/Request/RequestResource/Component/EditResource/Component/EditRequest.jsx,1,2,1
404b21a37090843c1da0d4e24a405c633df02729,codal-sid,frontend/src/Pages/Request/RequestResource/Component/MoveResourceStep/Component/Step1.jsx,2,4,2
f6cad1aa5783bd9cec01b9ba8c0df7e372bf82df,sshaikhcodal,backend/rptool/views.py,6,6,0
62c5ad68094602b5bc1585d851a9a87959af1ae6,codal-jsojitra,frontend/src/Pages/Request/RequestResource/Component/EditResource/Component/EditRequest.jsx,1,2,1
62c5ad68094602b5bc1585d851a9a87959af1ae6,codal-jsojitra,frontend/src/Pages/Request/RequestResource/Component/MoveResourceStep/Component/Step1.jsx,2,4,2
46f2789550f9d0d332848f99b494ac877eadb297,codal-sid,frontend/src/Assets/img/login_bg.png,0,0,0
46f2789550f9d0d332848f99b494ac877eadb297,codal-sid,frontend/src/Pages/Auth/Component/login.jsx,1,2,1
46f2789550f9d0d332848f99b494ac877eadb297,codal-sid,frontend/src/Pages/Projects/ProjectDetails/Component/project.jsx,1,2,1
46f2789550f9d0d332848f99b494ac877eadb297,codal-sid,frontend/src/Pages/Projects/ProjectList/Component/projectList.jsx,1,1,0
46f2789550f9d0d332848f99b494ac877eadb297,codal-sid,frontend/src/Pages/Request/RequestList/Component/request.jsx,1,2,1
46f2789550f9d0d332848f99b494ac877eadb297,codal-sid,frontend/src/Pages/Request/RequestResource/Component/MoveResourceStep/Component/Step1.jsx,22,33,11
46f2789550f9d0d332848f99b494ac877eadb297,codal-sid,frontend/src/Pages/Request/RequestResource/Component/MoveResourceStep/Container/index.js,1,2,1
46f2789550f9d0d332848f99b494ac877eadb297,codal-sid,frontend/src/Reducers/Request/GetApproveEmpProject.js,1,2,1
01ca19095501640feba66ee0330272ad59882e2a,codal-jsojitra,frontend/src/Pages/Request/RequestResource/Component/MoveResourceStep/Component/Step1.jsx,22,33,11
01ca19095501640feba66ee0330272ad59882e2a,codal-jsojitra,frontend/src/Pages/Request/RequestResource/Component/MoveResourceStep/Container/index.js,1,2,1
01ca19095501640feba66ee0330272ad59882e2a,codal-jsojitra,frontend/src/Reducers/Request/GetApproveEmpProject.js,1,2,1
12ed2550ed055e4d14b6077eee5f201dc673c011,codal-sid,backend/rptool/views.py,8,14,6
0422bab70969348518ca2407be3fb22a0df338e2,sshaikhcodal,backend/rptool/views.py,8,14,6
858334ff72d2c93488a8733bbfe5bfa39d581c3e,codal-jsojitra,frontend/src/Assets/img/login_bg.png,0,0,0
858334ff72d2c93488a8733bbfe5bfa39d581c3e,codal-jsojitra,frontend/src/Pages/Auth/Component/login.jsx,1,2,1
858334ff72d2c93488a8733bbfe5bfa39d581c3e,codal-jsojitra,frontend/src/Pages/Projects/ProjectDetails/Component/project.jsx,1,2,1
858334ff72d2c93488a8733bbfe5bfa39d581c3e,codal-jsojitra,frontend/src/Pages/Projects/ProjectList/Component/projectList.jsx,1,1,0
858334ff72d2c93488a8733bbfe5bfa39d581c3e,codal-jsojitra,frontend/src/Pages/Request/RequestList/Component/request.jsx,1,2,1
f76dde97160cdd12a37a6901746a2bbb86027215,codal-sid,backend/rptool/views.py,12,12,0
b487caf5c17874da01bad8eec4863f7d36181656,codal-sid,frontend/src/Actions/index.js,3,7,4
b487caf5c17874da01bad8eec4863f7d36181656,codal-sid,frontend/src/Actions/type.js,4,5,1
b487caf5c17874da01bad8eec4863f7d36181656,codal-sid,frontend/src/Pages/Projects/ProjectDetails/Component/project.jsx,4,7,3
b487caf5c17874da01bad8eec4863f7d36181656,codal-sid,frontend/src/Pages/Projects/ProjectDetails/Container/index.js,4,5,1
b487caf5c17874da01bad8eec4863f7d36181656,codal-sid,frontend/src/Pages/Request/RequestResource/Component/EditResource/Component/EditRequest.jsx,15,23,8
b487caf5c17874da01bad8eec4863f7d36181656,codal-sid,frontend/src/Pages/Request/RequestResource/Component/EditResource/Container/index.js,2,3,1
b487caf5c17874da01bad8eec4863f7d36181656,codal-sid,frontend/src/Pages/Request/RequestResource/Component/MoveResourceStep/Component/Step2.jsx,2,2,0
b487caf5c17874da01bad8eec4863f7d36181656,codal-sid,frontend/src/Pages/Request/RequestResource/Component/MoveResourceStep/Container/index.js,2,4,2
b487caf5c17874da01bad8eec4863f7d36181656,codal-sid,frontend/src/Pages/Request/RequestResource/Container/index.js,2,3,1
b487caf5c17874da01bad8eec4863f7d36181656,codal-sid,frontend/src/Reducers/Project/GetProjectByID.js,1,2,1
b487caf5c17874da01bad8eec4863f7d36181656,codal-sid,frontend/src/Reducers/Request/GetApproveEmpProject.js,1,2,1
b487caf5c17874da01bad8eec4863f7d36181656,codal-sid,frontend/src/Reducers/Request/GetEditRequestEmployee.js,20,20,0
b487caf5c17874da01bad8eec4863f7d36181656,codal-sid,frontend/src/Reducers/Request/GetEmployeebyProject.js,1,1,0
b487caf5c17874da01bad8eec4863f7d36181656,codal-sid,frontend/src/Reducers/ResourceRequest.js,2,4,2
b487caf5c17874da01bad8eec4863f7d36181656,codal-sid,frontend/src/Reducers/empLocationType.js,0,1,1
b487caf5c17874da01bad8eec4863f7d36181656,codal-sid,frontend/src/Reducers/index.js,4,5,1
32b2579d419c3bece914fe7e0e66b192acc7bc47,codal-jsojitra,frontend/src/Pages/Projects/ProjectDetails/Component/project.jsx,4,7,3
32b2579d419c3bece914fe7e0e66b192acc7bc47,codal-jsojitra,frontend/src/Pages/Projects/ProjectDetails/Container/index.js,4,5,1
32b2579d419c3bece914fe7e0e66b192acc7bc47,codal-jsojitra,frontend/src/Pages/Request/RequestResource/Component/MoveResourceStep/Component/Step2.jsx,2,2,0
32b2579d419c3bece914fe7e0e66b192acc7bc47,codal-jsojitra,frontend/src/Pages/Request/RequestResource/Component/MoveResourceStep/Container/index.js,2,4,2
c538aa80578bc567b941d7419738fb869fddb161,codal-sid,backend/rptool/views.py,14,27,13
715121d006736a8786d269a17e124405854b0951,codal-sid,backend/rptool/views.py,14,27,13
eeb5cb2f59b9af871d1bdadd90767c6573bac76c,codal-devops,appspec.yml,1,2,1
9d73960c32c81487963e39f69aeaf6dfe5e1d531,codal-devops,AfterInstall.sh,1,2,1
1c84cd4fb0c01c312215a106a94f2bf1c23ffb60,codal-devops,AfterInstall.sh,1,2,1
f404188c8dad7140be7ad21b046aee913fc7e02b,codal-devops,appspec.yml,1,2,1
4a5a135e732a66fa24e244f06b53819ed923eec7,codal-devops,AfterInstall.sh,17,17,0
4791e5d8441089b42309efdc4bd3f7ed35dd73a6,codal-devops,appspec.yml,13,18,5
56fe82926b010406028397209ce6237ae12ddf18,codal-jsojitra,frontend/src/Reducers/Project/GetProjectByID.js,1,2,1
f7b22f63ddd99826d9bc97935476f829ac697b42,codal-jsojitra,frontend/src/Pages/Request/RequestResource/Component/EditResource/Component/EditRequest.jsx,12,19,7
f7b22f63ddd99826d9bc97935476f829ac697b42,codal-jsojitra,frontend/src/Pages/Request/RequestResource/Container/index.js,1,2,1
f7b22f63ddd99826d9bc97935476f829ac697b42,codal-jsojitra,frontend/src/Reducers/Request/GetEditRequestEmployee.js,1,2,1
f7b22f63ddd99826d9bc97935476f829ac697b42,codal-jsojitra,frontend/src/Reducers/ResourceRequest.js,2,4,2
a069a9bb7f5208fde995bb85fb4e4cc5f28da152,sshaikhcodal,backend/rptool/views.py,12,12,0
8f467624539ccfc5472e99d4ebdea5468846f869,codal-jsojitra,frontend/src/Pages/Request/RequestResource/Component/RequestSubmit.jsx,3,7,4
8f467624539ccfc5472e99d4ebdea5468846f869,codal-jsojitra,frontend/src/Reducers/Request/GetApproveEmpProject.js,1,2,1
c05aeade206453baea42b98f51f906063921bf20,codal-jsojitra,frontend/src/Actions/index.js,3,7,4
c05aeade206453baea42b98f51f906063921bf20,codal-jsojitra,frontend/src/Actions/type.js,4,5,1
c05aeade206453baea42b98f51f906063921bf20,codal-jsojitra,frontend/src/Pages/Request/RequestResource/Component/EditResource/Component/EditRequest.jsx,7,12,5
c05aeade206453baea42b98f51f906063921bf20,codal-jsojitra,frontend/src/Pages/Request/RequestResource/Component/EditResource/Container/index.js,2,3,1
c05aeade206453baea42b98f51f906063921bf20,codal-jsojitra,frontend/src/Pages/Request/RequestResource/Component/RequestSubmit.jsx,4,7,3
c05aeade206453baea42b98f51f906063921bf20,codal-jsojitra,frontend/src/Pages/Request/RequestResource/Container/index.js,1,1,0
c05aeade206453baea42b98f51f906063921bf20,codal-jsojitra,frontend/src/Reducers/Request/GetEditRequestEmployee.js,20,20,0
c05aeade206453baea42b98f51f906063921bf20,codal-jsojitra,frontend/src/Reducers/Request/GetEmployeebyProject.js,1,1,0
c05aeade206453baea42b98f51f906063921bf20,codal-jsojitra,frontend/src/Reducers/empLocationType.js,0,1,1
c05aeade206453baea42b98f51f906063921bf20,codal-jsojitra,frontend/src/Reducers/index.js,4,5,1
e2d901e7aef178cd3c9c799b92519c2040a77c75,codal-sid,frontend/src/Pages/Request/EditChangeAllocation/Component/EditAllocation.jsx,1,2,1
e2d901e7aef178cd3c9c799b92519c2040a77c75,codal-sid,frontend/src/Pages/Request/RequestResource/Component/EditResource/Component/EditRequest.jsx,1,2,1
e2d901e7aef178cd3c9c799b92519c2040a77c75,codal-sid,frontend/src/Pages/Request/RequestResource/Component/MoveResourceStep/Component/MoveResource.jsx,1,2,1
e2d901e7aef178cd3c9c799b92519c2040a77c75,codal-sid,frontend/src/Pages/Request/RequestResource/Component/RequestSubmit.jsx,2,6,4
95dd079508ea81c85ee3316f0037ed07fd86c3c3,codal-jsojitra,frontend/src/Pages/Request/RequestResource/Component/RequestSubmit.jsx,2,5,3
0eac37e38fad8378c44ffaf7411bfdd7b89678e0,codal-jsojitra,frontend/src/Pages/Request/EditChangeAllocation/Component/EditAllocation.jsx,1,2,1
0eac37e38fad8378c44ffaf7411bfdd7b89678e0,codal-jsojitra,frontend/src/Pages/Request/RequestResource/Component/EditResource/Component/EditRequest.jsx,1,2,1
0eac37e38fad8378c44ffaf7411bfdd7b89678e0,codal-jsojitra,frontend/src/Pages/Request/RequestResource/Component/MoveResourceStep/Component/MoveResource.jsx,1,2,1
e7d9424d753c415c1cab95f73202cc44372a95e1,codal-jsojitra,frontend/src/Pages/Request/RequestResource/Component/RequestSubmit.jsx,2,5,3
93a0d172b98bb9e837d283a708f9580b452b042a,codal-sid,frontend/src/Pages/Projects/ProjectDetails/Component/project.jsx,26,43,17
93a0d172b98bb9e837d283a708f9580b452b042a,codal-sid,frontend/src/Pages/Request/EditRequest/Component/EditResource.jsx,10,12,2
93a0d172b98bb9e837d283a708f9580b452b042a,codal-sid,frontend/src/Pages/Request/RequestResource/Component/AddRequest/AddRequest.jsx,19,24,5
93a0d172b98bb9e837d283a708f9580b452b042a,codal-sid,frontend/src/Pages/Request/RequestResource/Component/RequestSubmit.jsx,1,1,0
3beae0730bfa8a93488b3e49d132d4734d6ce0a8,codal-jsojitra,frontend/src/Pages/Projects/ProjectDetails/Component/project.jsx,10,20,10
58e8950b4e1c50f2fcdfc1a5376d7e1cc29796c8,codal-jsojitra,frontend/src/Pages/Projects/ProjectDetails/Component/project.jsx,24,39,15
5a9fd46370bbdf50b36d8e43e6769e84bebc5940,codal-jsojitra,frontend/src/Pages/Projects/ProjectDetails/Component/project.jsx,3,6,3
5a9fd46370bbdf50b36d8e43e6769e84bebc5940,codal-jsojitra,frontend/src/Pages/Request/EditRequest/Component/EditResource.jsx,10,12,2
5a9fd46370bbdf50b36d8e43e6769e84bebc5940,codal-jsojitra,frontend/src/Pages/Request/RequestResource/Component/AddRequest/AddRequest.jsx,19,24,5
5a9fd46370bbdf50b36d8e43e6769e84bebc5940,codal-jsojitra,frontend/src/Pages/Request/RequestResource/Component/RequestSubmit.jsx,1,1,0
5fc21a977efc0d6f15a26da1a4ff8658a1528d29,ppatelcodal,backend/rptool/views.py,6,12,6
79991139e7a089111484b2808a0abb8358c5e3ec,pkiri-codal,backend/rptool/views.py,57,106,49
79991139e7a089111484b2808a0abb8358c5e3ec,pkiri-codal,frontend/src/Pages/People/Component/employee.jsx,5,7,2
79991139e7a089111484b2808a0abb8358c5e3ec,pkiri-codal,frontend/src/Pages/People/Component/upcoming.jsx,22,57,35
79991139e7a089111484b2808a0abb8358c5e3ec,pkiri-codal,frontend/src/Pages/Projects/ProjectDetails/Component/project.jsx,1,2,1
79991139e7a089111484b2808a0abb8358c5e3ec,pkiri-codal,frontend/src/Pages/Request/RequestList/Component/request.jsx,2,4,2
79991139e7a089111484b2808a0abb8358c5e3ec,pkiri-codal,frontend/src/Pages/UserProfile/Profile/Component/profile.jsx,1,2,1
36376db244add6bf6363919711c9e30a6da0819e,codal-sid,backend/rptool/views.py,57,106,49
bceb822bae7e0c8555643d6ef685df8e1e8d2db0,codal-sid,backend/rptool/views.py,22,23,1
6622a80b53533f972b46fcafdb49cb2962f93a3d,codal-sid,frontend/src/Pages/People/Component/employee.jsx,5,7,2
6622a80b53533f972b46fcafdb49cb2962f93a3d,codal-sid,frontend/src/Pages/People/Component/upcoming.jsx,22,57,35
6622a80b53533f972b46fcafdb49cb2962f93a3d,codal-sid,frontend/src/Pages/Projects/ProjectDetails/Component/project.jsx,1,2,1
6622a80b53533f972b46fcafdb49cb2962f93a3d,codal-sid,frontend/src/Pages/Request/RequestList/Component/request.jsx,2,4,2
6622a80b53533f972b46fcafdb49cb2962f93a3d,codal-sid,frontend/src/Pages/UserProfile/Profile/Component/profile.jsx,1,2,1
59b73d393f6d9d15a40262939f62e8e0e9c3c9f4,codal-jsojitra,frontend/src/Pages/People/Component/upcoming.jsx,9,12,3
f403de7afa021ceb05b6119168a7930f8312c37b,codal-jsojitra,frontend/src/Pages/People/Component/upcoming.jsx,1,2,1
d3ff9ab8ed74d56cb2cc0301a9901398a6c911a7,codal-jsojitra,frontend/src/Pages/People/Component/upcoming.jsx,2,28,26
2a98273603d9fbac06cdcb9360afe763838811c4,pkiri-codal,backend/rptool/views.py,3,6,3
d8b143e928b2c36b1ea4e4f9c745ff0505786803,codal-jsojitra,frontend/src/Pages/People/Component/employee.jsx,5,7,2
d8b143e928b2c36b1ea4e4f9c745ff0505786803,codal-jsojitra,frontend/src/Pages/People/Component/upcoming.jsx,18,31,13
d8b143e928b2c36b1ea4e4f9c745ff0505786803,codal-jsojitra,frontend/src/Pages/Projects/ProjectDetails/Component/project.jsx,1,2,1
d8b143e928b2c36b1ea4e4f9c745ff0505786803,codal-jsojitra,frontend/src/Pages/Request/RequestList/Component/request.jsx,2,4,2
d8b143e928b2c36b1ea4e4f9c745ff0505786803,codal-jsojitra,frontend/src/Pages/UserProfile/Profile/Component/profile.jsx,1,2,1
9656a57812f76daa454bdbc72ec8c465e0e2068c,pkiri-codal,frontend/src/Actions/index.js,0,2,2
9656a57812f76daa454bdbc72ec8c465e0e2068c,pkiri-codal,frontend/src/Pages/People/Component/employee.jsx,19,25,6
9656a57812f76daa454bdbc72ec8c465e0e2068c,pkiri-codal,frontend/src/Pages/Projects/AddProject/Component/addProject.jsx,11,16,5
9656a57812f76daa454bdbc72ec8c465e0e2068c,pkiri-codal,frontend/src/Pages/Projects/EditProject/Component/EditProject.js,9,12,3
9656a57812f76daa454bdbc72ec8c465e0e2068c,pkiri-codal,frontend/src/Pages/Projects/EditProject/Container/index.js,6,12,6
9656a57812f76daa454bdbc72ec8c465e0e2068c,pkiri-codal,frontend/src/Pages/Projects/ProjectList/Component/projectList.jsx,44,67,23
9656a57812f76daa454bdbc72ec8c465e0e2068c,pkiri-codal,frontend/src/Pages/Projects/ProjectList/Container/index.js,4,4,0
9656a57812f76daa454bdbc72ec8c465e0e2068c,pkiri-codal,frontend/src/Pages/Request/RequestList/Component/request.jsx,37,51,14
9656a57812f76daa454bdbc72ec8c465e0e2068c,pkiri-codal,frontend/src/Pages/Request/RequestList/Container/index.js,1,1,0
9656a57812f76daa454bdbc72ec8c465e0e2068c,pkiri-codal,frontend/src/Pages/Request/RequestResource/Component/AddRequest/AddRequest.jsx,9,14,5
9656a57812f76daa454bdbc72ec8c465e0e2068c,pkiri-codal,frontend/src/Pages/Request/RequestResource/Component/RequestSubmit.jsx,9,14,5
9656a57812f76daa454bdbc72ec8c465e0e2068c,pkiri-codal,frontend/src/Pages/UserProfile/Edit/Component/EditProfile.jsx,5,6,1
9656a57812f76daa454bdbc72ec8c465e0e2068c,pkiri-codal,frontend/src/Reducers/Resource/ResourceInfo.js,1,2,1
f48cf00f763db88e3ef4e4e97af92d1ee8979bbb,codal-sid,backend/rptool/views.py,39,91,52
616bddb5ff9d5184420a0892ffc8ecbcce9332f9,codal-sid,frontend/src/Actions/index.js,0,2,2
616bddb5ff9d5184420a0892ffc8ecbcce9332f9,codal-sid,frontend/src/Pages/People/Component/employee.jsx,19,25,6
616bddb5ff9d5184420a0892ffc8ecbcce9332f9,codal-sid,frontend/src/Pages/Projects/AddProject/Component/addProject.jsx,11,16,5
616bddb5ff9d5184420a0892ffc8ecbcce9332f9,codal-sid,frontend/src/Pages/Projects/EditProject/Component/EditProject.js,9,12,3
616bddb5ff9d5184420a0892ffc8ecbcce9332f9,codal-sid,frontend/src/Pages/Projects/EditProject/Container/index.js,6,12,6
616bddb5ff9d5184420a0892ffc8ecbcce9332f9,codal-sid,frontend/src/Pages/Projects/ProjectList/Component/projectList.jsx,44,67,23
616bddb5ff9d5184420a0892ffc8ecbcce9332f9,codal-sid,frontend/src/Pages/Projects/ProjectList/Container/index.js,4,4,0
616bddb5ff9d5184420a0892ffc8ecbcce9332f9,codal-sid,frontend/src/Pages/Request/RequestList/Component/request.jsx,37,51,14
616bddb5ff9d5184420a0892ffc8ecbcce9332f9,codal-sid,frontend/src/Pages/Request/RequestList/Container/index.js,1,1,0
616bddb5ff9d5184420a0892ffc8ecbcce9332f9,codal-sid,frontend/src/Pages/Request/RequestResource/Component/AddRequest/AddRequest.jsx,9,14,5
616bddb5ff9d5184420a0892ffc8ecbcce9332f9,codal-sid,frontend/src/Pages/Request/RequestResource/Component/RequestSubmit.jsx,9,14,5
616bddb5ff9d5184420a0892ffc8ecbcce9332f9,codal-sid,frontend/src/Pages/UserProfile/Edit/Component/EditProfile.jsx,5,6,1
616bddb5ff9d5184420a0892ffc8ecbcce9332f9,codal-sid,frontend/src/Reducers/Resource/ResourceInfo.js,1,2,1
49cc680dd638a066986a9569c832bd4a075c9646,codal-jsojitra,frontend/src/Actions/index.js,0,2,2
49cc680dd638a066986a9569c832bd4a075c9646,codal-jsojitra,frontend/src/Pages/People/Component/employee.jsx,19,25,6
49cc680dd638a066986a9569c832bd4a075c9646,codal-jsojitra,frontend/src/Pages/Projects/AddProject/Component/addProject.jsx,11,16,5
49cc680dd638a066986a9569c832bd4a075c9646,codal-jsojitra,frontend/src/Pages/Projects/EditProject/Component/EditProject.js,9,12,3
49cc680dd638a066986a9569c832bd4a075c9646,codal-jsojitra,frontend/src/Pages/Projects/EditProject/Container/index.js,6,12,6
49cc680dd638a066986a9569c832bd4a075c9646,codal-jsojitra,frontend/src/Pages/Projects/ProjectList/Component/projectList.jsx,44,67,23
49cc680dd638a066986a9569c832bd4a075c9646,codal-jsojitra,frontend/src/Pages/Projects/ProjectList/Container/index.js,4,4,0
49cc680dd638a066986a9569c832bd4a075c9646,codal-jsojitra,frontend/src/Pages/Request/RequestList/Component/request.jsx,37,51,14
49cc680dd638a066986a9569c832bd4a075c9646,codal-jsojitra,frontend/src/Pages/Request/RequestList/Container/index.js,1,1,0
49cc680dd638a066986a9569c832bd4a075c9646,codal-jsojitra,frontend/src/Pages/Request/RequestResource/Component/AddRequest/AddRequest.jsx,9,14,5
49cc680dd638a066986a9569c832bd4a075c9646,codal-jsojitra,frontend/src/Pages/Request/RequestResource/Component/RequestSubmit.jsx,9,14,5
49cc680dd638a066986a9569c832bd4a075c9646,codal-jsojitra,frontend/src/Pages/UserProfile/Edit/Component/EditProfile.jsx,5,6,1
49cc680dd638a066986a9569c832bd4a075c9646,codal-jsojitra,frontend/src/Reducers/Resource/ResourceInfo.js,1,2,1
0d2fb5c503453c4975d23a461823cd743070a959,pkiri-codal,backend/rptool/views.py,3,6,3
3b8287d1b55bb85fc697f57e798ac510e658fa77,codal-sid,frontend/src/Assets/css/scss/_project.scss,3,3,0
3b8287d1b55bb85fc697f57e798ac510e658fa77,codal-sid,frontend/src/Pages/Organization/Component/Organization.jsx,5,14,9
3b8287d1b55bb85fc697f57e798ac510e658fa77,codal-sid,frontend/src/Pages/People/Component/employee.jsx,7,15,8
3b8287d1b55bb85fc697f57e798ac510e658fa77,codal-sid,frontend/src/Pages/Projects/AddProject/Component/addProject.jsx,10,17,7
3b8287d1b55bb85fc697f57e798ac510e658fa77,codal-sid,frontend/src/Pages/Projects/ProjectDetails/Component/project.jsx,7,21,14
3b8287d1b55bb85fc697f57e798ac510e658fa77,codal-sid,frontend/src/Pages/Request/EditMoveAllocation/Component/EditMoveResource.jsx,13,21,8
3b8287d1b55bb85fc697f57e798ac510e658fa77,codal-sid,frontend/src/Pages/Request/RequestList/Component/request.jsx,5,6,1
3b8287d1b55bb85fc697f57e798ac510e658fa77,codal-sid,frontend/src/Pages/Request/RequestResource/Component/AddRequest/AddRequest.jsx,6,16,10
3b8287d1b55bb85fc697f57e798ac510e658fa77,codal-sid,frontend/src/Pages/Request/RequestResource/Component/EditResource/Component/EditRequest.jsx,13,21,8
3b8287d1b55bb85fc697f57e798ac510e658fa77,codal-sid,frontend/src/Pages/Request/RequestResource/Component/MoveResourceStep/Component/Step2.jsx,2,4,2
3b8287d1b55bb85fc697f57e798ac510e658fa77,codal-sid,frontend/src/Pages/Request/RequestResource/Component/RequestSubmit.jsx,3,6,3
84280a3e666683ffcf5f25222fff00895927953f,codal-ayush,backend/mainapp/settings.py,1,2,1
d48638812765c5ec42c224fe0485b3223edc0b8a,codal-ayush,backend/rptool/views.py,2,4,2
d48638812765c5ec42c224fe0485b3223edc0b8a,codal-ayush,frontend/src/Assets/css/scss/_project.scss,6,7,1
d48638812765c5ec42c224fe0485b3223edc0b8a,codal-ayush,frontend/src/Assets/css/scss/style.css,4,5,1
d48638812765c5ec42c224fe0485b3223edc0b8a,codal-ayush,frontend/src/Assets/css/scss/style.css.map,1,2,1
d48638812765c5ec42c224fe0485b3223edc0b8a,codal-ayush,frontend/src/Pages/Common/Component/Header.jsx,1,2,1
d48638812765c5ec42c224fe0485b3223edc0b8a,codal-ayush,frontend/src/Pages/People/Component/employee.jsx,9,9,0
d48638812765c5ec42c224fe0485b3223edc0b8a,codal-ayush,frontend/src/Pages/People/Component/upcoming.jsx,2,3,1
d48638812765c5ec42c224fe0485b3223edc0b8a,codal-ayush,frontend/src/Pages/Projects/AddProject/Component/addProject.jsx,2,3,1
d48638812765c5ec42c224fe0485b3223edc0b8a,codal-ayush,frontend/src/Pages/Projects/ProjectList/Component/projectList.jsx,4,6,2
d48638812765c5ec42c224fe0485b3223edc0b8a,codal-ayush,frontend/src/Pages/Request/RequestList/Component/request.jsx,10,13,3
3ab5ffe454f4b4ac8afd876eaacaeefc70a7faab,codal-ayush,backend/mainapp/settings.py,1,2,1
3ab5ffe454f4b4ac8afd876eaacaeefc70a7faab,codal-ayush,docker-compose.yml,2,80,78
3ab5ffe454f4b4ac8afd876eaacaeefc70a7faab,codal-ayush,docker-compose.yml.bak,78,80,2
37966aa96792be958f6c11e2d60f6ebea2f0c9aa,codal-jsojitra,frontend/src/Pages/People/Component/employee.jsx,7,15,8
37966aa96792be958f6c11e2d60f6ebea2f0c9aa,codal-jsojitra,frontend/src/Pages/Request/RequestResource/Component/AddRequest/AddRequest.jsx,6,16,10
bfec332351c864c48b2e0decd12ecdf2b43ebec2,codal-jsojitra,frontend/src/Pages/Projects/ProjectList/Component/projectList.jsx,1,2,1
bfec332351c864c48b2e0decd12ecdf2b43ebec2,codal-jsojitra,frontend/src/Pages/Request/RequestList/Component/request.jsx,5,7,2
e3632385577cff3c6eff3621d3d19e16c7dc52b2,codal-jsojitra,frontend/src/Assets/css/scss/_project.scss,3,3,0
e3632385577cff3c6eff3621d3d19e16c7dc52b2,codal-jsojitra,frontend/src/Pages/Projects/ProjectDetails/Component/project.jsx,4,8,4
e3632385577cff3c6eff3621d3d19e16c7dc52b2,codal-jsojitra,frontend/src/Pages/Projects/ProjectList/Component/projectList.jsx,1,2,1
bf9d9e68c545f2746e68e14e67411f952d476243,codal-jsojitra,frontend/src/Pages/Organization/Component/Organization.jsx,5,14,9
bf9d9e68c545f2746e68e14e67411f952d476243,codal-jsojitra,frontend/src/Pages/Projects/ProjectDetails/Component/project.jsx,3,13,10
bf9d9e68c545f2746e68e14e67411f952d476243,codal-jsojitra,frontend/src/Pages/Request/EditMoveAllocation/Component/EditMoveResource.jsx,13,21,8
bf9d9e68c545f2746e68e14e67411f952d476243,codal-jsojitra,frontend/src/Pages/Request/RequestResource/Component/EditResource/Component/EditRequest.jsx,13,21,8
bf9d9e68c545f2746e68e14e67411f952d476243,codal-jsojitra,frontend/src/Pages/Request/RequestResource/Component/MoveResourceStep/Component/Step2.jsx,2,4,2
bf9d9e68c545f2746e68e14e67411f952d476243,codal-jsojitra,frontend/src/Pages/Request/RequestResource/Component/RequestSubmit.jsx,3,6,3
ad12eeca905e3552be819628cd86433ed909adb4,codal-sid,backend/rptool/views.py,2,4,2
1d33cc23887f508f7c7bd3b2b318eb5df275db9c,pkiri-codal,backend/rptool/views.py,1,2,1
daa7c0319f4446c5167cefa781de19fe861d858b,pkiri-codal,backend/rptool/views.py,1,2,1
398b4cc65eff3fbd94b40880fc7e6b3c03e3b578,codal-jsojitra,frontend/src/Pages/Projects/AddProject/Component/addProject.jsx,10,17,7
398b4cc65eff3fbd94b40880fc7e6b3c03e3b578,codal-jsojitra,frontend/src/Pages/Request/RequestList/Component/request.jsx,1,1,0
f56fe875cab1b000b942d14ac4a88277c341411c,codal-sid,frontend/src/Pages/Projects/AddProject/Component/addProject.jsx,2,3,1
eb22225225fe620f20a04638ef27e98c9f1b5e49,codal-sid,frontend/src/Assets/css/scss/_project.scss,6,7,1
eb22225225fe620f20a04638ef27e98c9f1b5e49,codal-sid,frontend/src/Assets/css/scss/style.css,4,5,1
eb22225225fe620f20a04638ef27e98c9f1b5e49,codal-sid,frontend/src/Assets/css/scss/style.css.map,1,2,1
eb22225225fe620f20a04638ef27e98c9f1b5e49,codal-sid,frontend/src/Pages/Common/Component/Header.jsx,1,2,1
eb22225225fe620f20a04638ef27e98c9f1b5e49,codal-sid,frontend/src/Pages/People/Component/employee.jsx,9,9,0
eb22225225fe620f20a04638ef27e98c9f1b5e49,codal-sid,frontend/src/Pages/People/Component/upcoming.jsx,2,3,1
eb22225225fe620f20a04638ef27e98c9f1b5e49,codal-sid,frontend/src/Pages/Projects/ProjectList/Component/projectList.jsx,4,6,2
eb22225225fe620f20a04638ef27e98c9f1b5e49,codal-sid,frontend/src/Pages/Request/RequestList/Component/request.jsx,10,13,3
f95601981b184af5ad617630384980f02a26e89f,codal-jsojitra,frontend/src/Assets/css/scss/_project.scss,6,7,1
f95601981b184af5ad617630384980f02a26e89f,codal-jsojitra,frontend/src/Assets/css/scss/style.css,4,5,1
f95601981b184af5ad617630384980f02a26e89f,codal-jsojitra,frontend/src/Assets/css/scss/style.css.map,1,2,1
f95601981b184af5ad617630384980f02a26e89f,codal-jsojitra,frontend/src/Pages/Projects/ProjectList/Component/projectList.jsx,1,2,1
0d3eec43d68d0287ab1051ecd2935ef6db93aa8f,codal-jsojitra,frontend/src/Pages/People/Component/employee.jsx,8,10,2
0d3eec43d68d0287ab1051ecd2935ef6db93aa8f,codal-jsojitra,frontend/src/Pages/Projects/ProjectList/Component/projectList.jsx,3,4,1
7a68c423df49e4e799b916999bcfb7a119250bd5,codal-jsojitra,frontend/src/Pages/People/Component/employee.jsx,5,7,2
7a68c423df49e4e799b916999bcfb7a119250bd5,codal-jsojitra,frontend/src/Pages/People/Component/upcoming.jsx,2,3,1
7a68c423df49e4e799b916999bcfb7a119250bd5,codal-jsojitra,frontend/src/Pages/Request/RequestList/Component/request.jsx,10,13,3
1ae5af6a9d1ca1f8e372c21fd8d518bda71e824e,codal-jsojitra,frontend/src/Pages/Projects/AddProject/Component/addProject.jsx,2,3,1
379d3d88f49e1e043719e41cd6b5aef890452774,codal-ayush,backend/mainapp/settings.py,1,2,1
379d3d88f49e1e043719e41cd6b5aef890452774,codal-ayush,docker-compose.yml,78,80,2
379d3d88f49e1e043719e41cd6b5aef890452774,codal-ayush,docker-compose.yml.bak,2,80,78
e0785b9c2b4e78541bbf4a75b15b271e92b0cc71,ppatelcodal,backend/rptool/views.py,5,8,3
508dde23c2efd1277b82792ef71e9fb17e5cf63a,pkiri-codal,backend/rptool/views.py,1,2,1
3eaed10ae4d7a38540ab7f16eccc1b7b6634bbd8,codal-devops,docker-compose-test.yml,0,94,94
6f899faa7c1b84f9a9df8f146c8d5e2f792f0593,codal-ayush,backend/mainapp/settings.py,1,2,1
6f899faa7c1b84f9a9df8f146c8d5e2f792f0593,codal-ayush,docker-compose.yml,2,80,78
6f899faa7c1b84f9a9df8f146c8d5e2f792f0593,codal-ayush,docker-compose.yml.bak,167,167,0
4c214d51623f504e987f75a4531518e6e3877c18,pkiri-codal,backend/rptool/views.py,1,2,1
a374ef7adf9530c4a3dab97ae11ce302d5865192,pkiri-codal,backend/rptool/views.py,1,2,1
3b79d4833e05cdfe337feca43c107ccf5becc511,pkiri-codal,docker-compose-test.yml,94,94,0
3b79d4833e05cdfe337feca43c107ccf5becc511,pkiri-codal,docker-compose.yml,12,24,12
59a44ac405f46d878304921d3f27d2f2979287a8,pkiri-codal,backend/rptool/views.py,4,7,3
7eabe540698511f8175edde0c8fbe02baf58e44a,codal-devops,docker-compose.yml,12,24,12
4a3798ff252f332000a5edc4e90da059845f5b9e,codal-devops,docker-compose-test.yml,94,94,0
e4e0986ec65e86e11abbe99b0509060729bb83e6,pkiri-codal,backend/rptool/views.py,3,5,2
21a41327de61749f4e63b0b85deb53757ae08050,codal-sid,backend/rptool/views.py,1,2,1
320e065ef6d28a9991ed58d5312484962bb5568b,pkiri-codal,backend/rptool/views.py,1,2,1
ced77fd233deb33680a24fec1501b71f0fa4926f,pkiri-codal,backend/rptool/views.py,2,4,2
0752d597b61e017746c499c281677e92f85bf9ae,codal-devops,frontend/docker/Dockerfile,12,14,2
e370e69d35f2b57dcf9ada30f8cc8cbbde7ec8a1,codal-sid,backend/rptool/views.py,13,27,14
a5a5e6797b40732f72f19cbc60fcce6963495858,codal-sid,backend/rptool/views.py,13,27,14
e56265407318613623c9b2ff52fe2ac48b575ea0,codal-jsojitra,frontend/src/Pages/Common/Component/Header.jsx,1,2,1
2f4c8eb66861885f8a72de1fc69af0d89f5dd711,codal-sid,frontend/src/Pages/Projects/ProjectList/Component/projectList.jsx,10,22,12
072c1ec4dadc1c3cf288cf0323c193f0c580b996,codal-jsojitra,frontend/src/Pages/Projects/ProjectList/Component/projectList.jsx,10,22,12
6a55c226b8ea7abc9f76c409b76f74bfe1df9431,codal-sid,frontend/src/Pages/People/Component/upcoming.jsx,1,1,0
18bcb93fcd6db8e932e702254a09ccbaf96edb23,codal-jsojitra,frontend/src/Pages/People/Component/upcoming.jsx,1,1,0
2663e08bf21482ea85a31df8544016c3afb4d5a6,codal-sid,frontend/src/Assets/css/scss/_project.scss,3,3,0
2663e08bf21482ea85a31df8544016c3afb4d5a6,codal-sid,frontend/src/Assets/css/scss/style.css,4,4,0
2663e08bf21482ea85a31df8544016c3afb4d5a6,codal-sid,frontend/src/Assets/css/scss/style.css.map,1,2,1
2663e08bf21482ea85a31df8544016c3afb4d5a6,codal-sid,frontend/src/Pages/Projects/ProjectDetails/Component/project.jsx,3,6,3
2663e08bf21482ea85a31df8544016c3afb4d5a6,codal-sid,frontend/src/Pages/UserProfile/Profile/Component/profile.jsx,12,24,12
9f41af4eaf815d676140f7006db1c0cc8f5bf388,codal-jsojitra,frontend/src/Assets/css/scss/_project.scss,3,3,0
9f41af4eaf815d676140f7006db1c0cc8f5bf388,codal-jsojitra,frontend/src/Assets/css/scss/style.css,4,4,0
9f41af4eaf815d676140f7006db1c0cc8f5bf388,codal-jsojitra,frontend/src/Assets/css/scss/style.css.map,1,2,1
9f41af4eaf815d676140f7006db1c0cc8f5bf388,codal-jsojitra,frontend/src/Pages/UserProfile/Profile/Component/profile.jsx,12,24,12
d190573ffed68cd7ec1fd07094dfd470de195a9a,codal-jsojitra,frontend/src/Pages/Projects/ProjectDetails/Component/project.jsx,3,6,3
4b6eab900eba80e760907697bf0861f674968ce7,codal-sid,frontend/src/Actions/index.js,3,4,1
4b6eab900eba80e760907697bf0861f674968ce7,codal-sid,frontend/src/Pages/Projects/ProjectDetails/Component/project.jsx,3,4,1
bcf2d3d9b236ceac5457646fffc2799961e90af8,codal-jsojitra,frontend/src/Actions/index.js,3,4,1
bcf2d3d9b236ceac5457646fffc2799961e90af8,codal-jsojitra,frontend/src/Pages/Projects/ProjectDetails/Component/project.jsx,3,4,1
ffdb4cd884efa85eb1d68a16a937a6b601048188,codal-sid,backend/rptool/admin.py,8,9,1
ffdb4cd884efa85eb1d68a16a937a6b601048188,codal-sid,backend/rptool/migrations/0036_employeejiraaccount.py,25,25,0
ffdb4cd884efa85eb1d68a16a937a6b601048188,codal-sid,backend/rptool/models.py,14,14,0
ffdb4cd884efa85eb1d68a16a937a6b601048188,codal-sid,backend/rptool/serializers.py,20,24,4
ffdb4cd884efa85eb1d68a16a937a6b601048188,codal-sid,backend/rptool/tasks.py,70,102,32
ffdb4cd884efa85eb1d68a16a937a6b601048188,codal-sid,backend/rptool/views.py,19,29,10
f79035582a933523c204176daa10686acc31eaf2,codal-sid,backend/rptool/serializers.py,4,8,4
0954faf0974051ab99fc141e4eb27a7c40a004f1,codal-sid,backend/rptool/admin.py,8,9,1
0954faf0974051ab99fc141e4eb27a7c40a004f1,codal-sid,backend/rptool/migrations/0036_employeejiraaccount.py,25,25,0
0954faf0974051ab99fc141e4eb27a7c40a004f1,codal-sid,backend/rptool/models.py,14,14,0
0954faf0974051ab99fc141e4eb27a7c40a004f1,codal-sid,backend/rptool/serializers.py,16,16,0
0954faf0974051ab99fc141e4eb27a7c40a004f1,codal-sid,backend/rptool/tasks.py,70,102,32
0954faf0974051ab99fc141e4eb27a7c40a004f1,codal-sid,backend/rptool/views.py,19,29,10
50d6016c8703208cfec7d448eeef48d7cb253eaf,codal-sid,frontend/src/Pages/Projects/AddProject/Component/addProject.jsx,4,13,9
1d135c5567e88e53ee4fa69afd627add1144620a,codal-jsojitra,frontend/src/Pages/Projects/AddProject/Component/addProject.jsx,2,4,2
091b4d4d3407931c1ed59548e9f3819fec59a36e,codal-jsojitra,frontend/src/Pages/Projects/AddProject/Component/addProject.jsx,4,13,9
ab842eaceb83c5485b7cbfa494fd4216bf9de1d9,codal-sid,frontend/package-lock.json,9,9,0
ab842eaceb83c5485b7cbfa494fd4216bf9de1d9,codal-sid,frontend/package.json,1,1,0
ab842eaceb83c5485b7cbfa494fd4216bf9de1d9,codal-sid,frontend/src/Actions/index.js,3,4,1
ab842eaceb83c5485b7cbfa494fd4216bf9de1d9,codal-sid,frontend/src/Actions/type.js,1,1,0
ab842eaceb83c5485b7cbfa494fd4216bf9de1d9,codal-sid,frontend/src/Assets/css/scss/_project.scss,8,8,0
ab842eaceb83c5485b7cbfa494fd4216bf9de1d9,codal-sid,frontend/src/Assets/css/scss/style.css,9,9,0
ab842eaceb83c5485b7cbfa494fd4216bf9de1d9,codal-sid,frontend/src/Assets/css/scss/style.css.map,1,2,1
ab842eaceb83c5485b7cbfa494fd4216bf9de1d9,codal-sid,frontend/src/Pages/People/Component/employee.jsx,11,14,3
ab842eaceb83c5485b7cbfa494fd4216bf9de1d9,codal-sid,frontend/src/Pages/Projects/AddProject/Component/addProject.jsx,28,34,6
ab842eaceb83c5485b7cbfa494fd4216bf9de1d9,codal-sid,frontend/src/Pages/Projects/ProjectDetails/Component/project.jsx,7,9,2
ab842eaceb83c5485b7cbfa494fd4216bf9de1d9,codal-sid,frontend/src/Pages/Projects/ProjectList/Component/projectList.jsx,6,11,5
ab842eaceb83c5485b7cbfa494fd4216bf9de1d9,codal-sid,frontend/src/Pages/Request/RequestList/Component/request.jsx,6,7,1
ab842eaceb83c5485b7cbfa494fd4216bf9de1d9,codal-sid,frontend/src/Pages/Request/RequestResource/Component/RequestSubmit.jsx,7,11,4
ab842eaceb83c5485b7cbfa494fd4216bf9de1d9,codal-sid,frontend/src/Reducers/Project/GetJiraLog.js,4,6,2
41554e259fa7f564a9e378e9e602aa5ac565bdf8,codal-jsojitra,frontend/src/Pages/Projects/AddProject/Component/addProject.jsx,1,2,1
498a1ebcf67e0ff377ace2f57c4b27a5f9396960,codal-jsojitra,frontend/package-lock.json,9,9,0
498a1ebcf67e0ff377ace2f57c4b27a5f9396960,codal-jsojitra,frontend/package.json,1,1,0
498a1ebcf67e0ff377ace2f57c4b27a5f9396960,codal-jsojitra,frontend/src/Assets/css/scss/_project.scss,6,7,1
498a1ebcf67e0ff377ace2f57c4b27a5f9396960,codal-jsojitra,frontend/src/Assets/css/scss/style.css,9,9,0
498a1ebcf67e0ff377ace2f57c4b27a5f9396960,codal-jsojitra,frontend/src/Assets/css/scss/style.css.map,1,2,1
498a1ebcf67e0ff377ace2f57c4b27a5f9396960,codal-jsojitra,frontend/src/Pages/Projects/AddProject/Component/addProject.jsx,6,14,8
4265b656a715dc5134179ac0c88bad75fe2cdc20,codal-jsojitra,frontend/src/Pages/Request/RequestList/Component/request.jsx,6,7,1
ddaaff92b3a830727dd0c1d5ea43536474b69c33,codal-jsojitra,frontend/src/Assets/css/scss/_project.scss,3,3,0
ddaaff92b3a830727dd0c1d5ea43536474b69c33,codal-jsojitra,frontend/src/Assets/css/scss/style.css.map,1,2,1
ddaaff92b3a830727dd0c1d5ea43536474b69c33,codal-jsojitra,frontend/src/Pages/People/Component/employee.jsx,11,14,3
ddaaff92b3a830727dd0c1d5ea43536474b69c33,codal-jsojitra,frontend/src/Pages/Projects/AddProject/Component/addProject.jsx,12,14,2
ddaaff92b3a830727dd0c1d5ea43536474b69c33,codal-jsojitra,frontend/src/Pages/Projects/ProjectList/Component/projectList.jsx,2,3,1
3c5b888876c1aaca728cd678723132629b7e96ca,codal-sid,backend/requirements.txt,3,3,0
e0efda527b08e8fc674c992f06566e86d259e53a,codal-sid,backend/requirements.txt,3,3,0
6d40dd01892b9c5f4c2e4aaaca8531010662cdcc,codal-jsojitra,frontend/src/Pages/Projects/AddProject/Component/addProject.jsx,18,22,4
6d40dd01892b9c5f4c2e4aaaca8531010662cdcc,codal-jsojitra,frontend/src/Pages/Projects/ProjectList/Component/projectList.jsx,4,8,4
6d40dd01892b9c5f4c2e4aaaca8531010662cdcc,codal-jsojitra,frontend/src/Pages/Request/RequestResource/Component/RequestSubmit.jsx,7,11,4
09b4901892a311bb395a5c4fb2919d873cdb00d2,codal-jsojitra,frontend/src/Actions/index.js,3,4,1
09b4901892a311bb395a5c4fb2919d873cdb00d2,codal-jsojitra,frontend/src/Actions/type.js,1,1,0
09b4901892a311bb395a5c4fb2919d873cdb00d2,codal-jsojitra,frontend/src/Pages/Projects/ProjectDetails/Component/project.jsx,7,9,2
09b4901892a311bb395a5c4fb2919d873cdb00d2,codal-jsojitra,frontend/src/Reducers/Project/GetJiraLog.js,4,6,2
d3a5e3c6ca2e2a4a7e65fe8ff569f03714117754,codal-sid,frontend/src/Actions/index.js,2,3,1
d3a5e3c6ca2e2a4a7e65fe8ff569f03714117754,codal-sid,frontend/src/Pages/Projects/AddProject/Component/addProject.jsx,24,31,7
d3a5e3c6ca2e2a4a7e65fe8ff569f03714117754,codal-sid,frontend/src/Pages/Projects/AddProject/Container/index.js,2,4,2
d3a5e3c6ca2e2a4a7e65fe8ff569f03714117754,codal-sid,frontend/src/Pages/Projects/EditProject/Component/EditProject.js,2,4,2
d3a5e3c6ca2e2a4a7e65fe8ff569f03714117754,codal-sid,frontend/src/common/googleConfig.js,1,2,1
a5c41fba58cf561763b247ba8a94980f12332b12,codal-jsojitra,frontend/src/common/googleConfig.js,1,2,1
17f389e09cc2466fba45bd1625fa8e1d6910460f,codal-jsojitra,frontend/src/Actions/index.js,2,3,1
17f389e09cc2466fba45bd1625fa8e1d6910460f,codal-jsojitra,frontend/src/Pages/Projects/AddProject/Component/addProject.jsx,3,4,1
17f389e09cc2466fba45bd1625fa8e1d6910460f,codal-jsojitra,frontend/src/Pages/Projects/AddProject/Container/index.js,2,4,2
17f389e09cc2466fba45bd1625fa8e1d6910460f,codal-jsojitra,frontend/src/Pages/Projects/EditProject/Component/EditProject.js,2,4,2
da8ea09e4811a050711cbe28729632674739260e,codal-jsojitra,frontend/src/Pages/Projects/AddProject/Component/addProject.jsx,21,27,6
beacc7a086972480137a5d8e4e167caa7646e5f7,codal-sid,frontend/src/Actions/index.js,68,69,1
beacc7a086972480137a5d8e4e167caa7646e5f7,codal-sid,frontend/src/Actions/type.js,10,10,0
beacc7a086972480137a5d8e4e167caa7646e5f7,codal-sid,frontend/src/Assets/css/scss/_orgnation.scss,2,2,0
beacc7a086972480137a5d8e4e167caa7646e5f7,codal-sid,frontend/src/Assets/css/scss/_project.scss,21,21,0
beacc7a086972480137a5d8e4e167caa7646e5f7,codal-sid,frontend/src/Assets/css/scss/style.css,20,20,0
beacc7a086972480137a5d8e4e167caa7646e5f7,codal-sid,frontend/src/Assets/css/scss/style.css.map,1,2,1
beacc7a086972480137a5d8e4e167caa7646e5f7,codal-sid,frontend/src/Pages/Organization/Component/Organization.jsx,130,247,117
beacc7a086972480137a5d8e4e167caa7646e5f7,codal-sid,frontend/src/Pages/Organization/Container/index.js,3,3,0
beacc7a086972480137a5d8e4e167caa7646e5f7,codal-sid,frontend/src/Pages/Projects/AddProject/Component/addProject.jsx,230,370,140
beacc7a086972480137a5d8e4e167caa7646e5f7,codal-sid,frontend/src/Pages/Projects/AddProject/Container/index.js,14,16,2
beacc7a086972480137a5d8e4e167caa7646e5f7,codal-sid,frontend/src/Pages/Projects/EditProject/Component/EditProject.js,12,23,11
beacc7a086972480137a5d8e4e167caa7646e5f7,codal-sid,frontend/src/Pages/Projects/EditProject/Container/index.js,9,10,1
beacc7a086972480137a5d8e4e167caa7646e5f7,codal-sid,frontend/src/Pages/Projects/ProjectDetails/Component/project.jsx,1,2,1
beacc7a086972480137a5d8e4e167caa7646e5f7,codal-sid,frontend/src/Reducers/Project/AddJiraAccount.js,19,19,0
beacc7a086972480137a5d8e4e167caa7646e5f7,codal-sid,frontend/src/Reducers/Project/GetJiraAccounts.js,17,17,0
beacc7a086972480137a5d8e4e167caa7646e5f7,codal-sid,frontend/src/Reducers/Project/GetJiraProjects.js,20,20,0
beacc7a086972480137a5d8e4e167caa7646e5f7,codal-sid,frontend/src/Reducers/index.js,7,10,3
0f123496add240d030f211b86e907bc55c31909d,codal-jsojitra,frontend/src/Actions/index.js,27,30,3
0f123496add240d030f211b86e907bc55c31909d,codal-jsojitra,frontend/src/Actions/type.js,5,6,1
0f123496add240d030f211b86e907bc55c31909d,codal-jsojitra,frontend/src/Assets/css/scss/_project.scss,21,21,0
0f123496add240d030f211b86e907bc55c31909d,codal-jsojitra,frontend/src/Assets/css/scss/style.css,20,20,0
0f123496add240d030f211b86e907bc55c31909d,codal-jsojitra,frontend/src/Assets/css/scss/style.css.map,1,2,1
0f123496add240d030f211b86e907bc55c31909d,codal-jsojitra,frontend/src/Pages/Projects/AddProject/Component/addProject.jsx,88,163,75
0f123496add240d030f211b86e907bc55c31909d,codal-jsojitra,frontend/src/Pages/Projects/AddProject/Container/index.js,6,7,1
0f123496add240d030f211b86e907bc55c31909d,codal-jsojitra,frontend/src/Pages/Projects/EditProject/Component/EditProject.js,12,26,14
0f123496add240d030f211b86e907bc55c31909d,codal-jsojitra,frontend/src/Pages/Projects/ProjectDetails/Component/project.jsx,1,2,1
0f123496add240d030f211b86e907bc55c31909d,codal-jsojitra,frontend/src/Reducers/Project/AddJiraAccount.js,19,19,0
0f123496add240d030f211b86e907bc55c31909d,codal-jsojitra,frontend/src/Reducers/Project/GetJiraProjects.js,5,7,2
0f123496add240d030f211b86e907bc55c31909d,codal-jsojitra,frontend/src/Reducers/index.js,3,5,2
d563b7af5b52451960b6b57db5690a35198b19e5,codal-sid,backend/rptool/signals.py,6,9,3
4864243588f00cb7f6940d933333302c2d6f83e4,codal-sid,backend/rptool/signals.py,6,9,3
e4590b629bab941c05a9d0d81d6354627ee638a0,codal-sid,backend/rptool/views.py,7,7,0
1f238a2ef7a064d7b4ae573273931c2685cf02eb,codal-sid,backend/rptool/views.py,7,7,0
7ecffbca262b3df1bc540f2050ec26372eeb1970,codal-jsojitra,frontend/src/Actions/index.js,44,45,1
7ecffbca262b3df1bc540f2050ec26372eeb1970,codal-jsojitra,frontend/src/Actions/type.js,6,6,0
7ecffbca262b3df1bc540f2050ec26372eeb1970,codal-jsojitra,frontend/src/Assets/css/scss/_orgnation.scss,2,2,0
7ecffbca262b3df1bc540f2050ec26372eeb1970,codal-jsojitra,frontend/src/Assets/css/scss/style.css.map,1,2,1
7ecffbca262b3df1bc540f2050ec26372eeb1970,codal-jsojitra,frontend/src/Pages/Organization/Component/Organization.jsx,127,247,120
7ecffbca262b3df1bc540f2050ec26372eeb1970,codal-jsojitra,frontend/src/Pages/Organization/Container/index.js,3,3,0
7ecffbca262b3df1bc540f2050ec26372eeb1970,codal-jsojitra,frontend/src/Pages/Projects/AddProject/Component/addProject.jsx,147,217,70
7ecffbca262b3df1bc540f2050ec26372eeb1970,codal-jsojitra,frontend/src/Pages/Projects/AddProject/Container/index.js,9,11,2
7ecffbca262b3df1bc540f2050ec26372eeb1970,codal-jsojitra,frontend/src/Pages/Projects/EditProject/Component/EditProject.js,7,11,4
7ecffbca262b3df1bc540f2050ec26372eeb1970,codal-jsojitra,frontend/src/Pages/Projects/EditProject/Container/index.js,9,10,1
7ecffbca262b3df1bc540f2050ec26372eeb1970,codal-jsojitra,frontend/src/Reducers/Project/GetJiraAccounts.js,17,17,0
7ecffbca262b3df1bc540f2050ec26372eeb1970,codal-jsojitra,frontend/src/Reducers/Project/GetJiraProjects.js,17,17,0
7ecffbca262b3df1bc540f2050ec26372eeb1970,codal-jsojitra,frontend/src/Reducers/index.js,5,7,2
f34fb00030aee13abdc403d82e788f08b2f5d207,codal-sid,backend/rptool/admin.py,3,3,0
f34fb00030aee13abdc403d82e788f08b2f5d207,codal-sid,backend/rptool/migrations/0035_auto_20200421_1302.py,34,34,0
f34fb00030aee13abdc403d82e788f08b2f5d207,codal-sid,backend/rptool/models.py,9,9,0
f34fb00030aee13abdc403d82e788f08b2f5d207,codal-sid,backend/rptool/permissions.py,13,14,1
f34fb00030aee13abdc403d82e788f08b2f5d207,codal-sid,backend/rptool/serializers.py,59,64,5
f34fb00030aee13abdc403d82e788f08b2f5d207,codal-sid,backend/rptool/urls.py,3,5,2
f34fb00030aee13abdc403d82e788f08b2f5d207,codal-sid,backend/rptool/views.py,48,50,2
b079e97b152b5a834f3837a1c69c20cd58c889fa,codal-sid,backend/rptool/admin.py,3,3,0
b079e97b152b5a834f3837a1c69c20cd58c889fa,codal-sid,backend/rptool/migrations/0035_auto_20200421_1302.py,34,34,0
b079e97b152b5a834f3837a1c69c20cd58c889fa,codal-sid,backend/rptool/models.py,9,9,0
b079e97b152b5a834f3837a1c69c20cd58c889fa,codal-sid,backend/rptool/permissions.py,13,14,1
b079e97b152b5a834f3837a1c69c20cd58c889fa,codal-sid,backend/rptool/serializers.py,59,64,5
b079e97b152b5a834f3837a1c69c20cd58c889fa,codal-sid,backend/rptool/urls.py,3,5,2
b079e97b152b5a834f3837a1c69c20cd58c889fa,codal-sid,backend/rptool/views.py,48,50,2
8c503829a9fde1ec73136855211f813477a0491b,codal-jsojitra,frontend/src/Pages/Organization/Component/Organization.jsx,11,16,5
8568273dea4198a47423a77f14903b4fa777834e,codal-sid,frontend/src/Actions/index.js,32,36,4
8568273dea4198a47423a77f14903b4fa777834e,codal-sid,frontend/src/Assets/css/scss/_project.scss,23,24,1
8568273dea4198a47423a77f14903b4fa777834e,codal-sid,frontend/src/Assets/css/scss/style.css,19,19,0
8568273dea4198a47423a77f14903b4fa777834e,codal-sid,frontend/src/Assets/css/scss/style.css.map,1,2,1
8568273dea4198a47423a77f14903b4fa777834e,codal-sid,frontend/src/Pages/Organization/Component/Organization.jsx,19,36,17
8568273dea4198a47423a77f14903b4fa777834e,codal-sid,frontend/src/Pages/Organization/Container/index.js,3,6,3
8568273dea4198a47423a77f14903b4fa777834e,codal-sid,frontend/src/Pages/Projects/AddProject/Component/addProject.jsx,189,200,11
8568273dea4198a47423a77f14903b4fa777834e,codal-sid,frontend/src/Pages/Projects/ProjectList/Component/projectList.jsx,4,8,4
8568273dea4198a47423a77f14903b4fa777834e,codal-sid,frontend/src/Pages/Request/RequestList/Component/request.jsx,5,10,5
8568273dea4198a47423a77f14903b4fa777834e,codal-sid,frontend/src/Pages/UserProfile/Edit/Component/EditProfile.jsx,41,91,50
8568273dea4198a47423a77f14903b4fa777834e,codal-sid,frontend/src/Pages/UserProfile/Edit/Container/index.js,3,3,0
583a1586c3f68ffc040d34612d10bcae91261cc8,codal-jsojitra,frontend/src/Pages/Organization/Component/Organization.jsx,4,8,4
79be0f6ff53c5cecf36d1c642d3eed5dc669d0c9,codal-jsojitra,frontend/src/Actions/index.js,32,36,4
79be0f6ff53c5cecf36d1c642d3eed5dc669d0c9,codal-jsojitra,frontend/src/Pages/Organization/Component/Organization.jsx,19,36,17
79be0f6ff53c5cecf36d1c642d3eed5dc669d0c9,codal-jsojitra,frontend/src/Pages/Organization/Container/index.js,3,6,3
79be0f6ff53c5cecf36d1c642d3eed5dc669d0c9,codal-jsojitra,frontend/src/Pages/UserProfile/Edit/Component/EditProfile.jsx,13,22,9
79be0f6ff53c5cecf36d1c642d3eed5dc669d0c9,codal-jsojitra,frontend/src/Pages/UserProfile/Edit/Container/index.js,3,3,0
47648e54aea12aabb5646001e5fe9817641528ea,codal-sid,backend/.gitignore,1,1,0
47648e54aea12aabb5646001e5fe9817641528ea,codal-sid,backend/rptool/tasks.py,80,80,0
247fff6b38ee42bd7972edb837a15049bffefc9a,codal-sid,backend/.gitignore,1,1,0
247fff6b38ee42bd7972edb837a15049bffefc9a,codal-sid,backend/rptool/tasks.py,80,80,0
750b358b237d2f203c7485b8aa44e571ebd4f6d6,codal-jsojitra,frontend/src/Pages/Projects/AddProject/Component/addProject.jsx,5,10,5
750b358b237d2f203c7485b8aa44e571ebd4f6d6,codal-jsojitra,frontend/src/Pages/Projects/ProjectList/Component/projectList.jsx,4,8,4
68ed6050064e4e86d438529e5fc17988e85bd118,codal-jsojitra,frontend/src/Pages/UserProfile/Edit/Component/EditProfile.jsx,37,89,52
b0f8afec72479457da96f8da66da5a91cf54b337,codal-jsojitra,frontend/src/Pages/Request/RequestList/Component/request.jsx,5,10,5
b0f8afec72479457da96f8da66da5a91cf54b337,codal-jsojitra,frontend/src/Pages/UserProfile/Edit/Component/EditProfile.jsx,37,89,52
68381c80bbd3fc75a7deaba4067652b5ce7657cd,codal-jsojitra,frontend/src/Pages/Projects/AddProject/Component/addProject.jsx,11,199,188
68381c80bbd3fc75a7deaba4067652b5ce7657cd,codal-jsojitra,frontend/src/Pages/Projects/ProjectList/Component/projectList.jsx,4,8,4
948800ecd18cc7d5dedd0e723b6ba7e07fd9e0c4,codal-jsojitra,frontend/src/Pages/Projects/AddProject/Component/addProject.jsx,1,1,0
eae15525365be880de8704a4887a9061e8740aac,codal-jsojitra,frontend/src/Assets/css/scss/_project.scss,7,13,6
eae15525365be880de8704a4887a9061e8740aac,codal-jsojitra,frontend/src/Assets/css/scss/style.css,4,8,4
eae15525365be880de8704a4887a9061e8740aac,codal-jsojitra,frontend/src/Assets/css/scss/style.css.map,1,2,1
eae15525365be880de8704a4887a9061e8740aac,codal-jsojitra,frontend/src/Pages/Projects/AddProject/Component/addProject.jsx,8,14,6
8c7fc2c591d9788184169cfe6cd8a31ca4d079be,codal-jsojitra,frontend/src/Assets/css/scss/_project.scss,22,23,1
8c7fc2c591d9788184169cfe6cd8a31ca4d079be,codal-jsojitra,frontend/src/Assets/css/scss/style.css,19,19,0
8c7fc2c591d9788184169cfe6cd8a31ca4d079be,codal-jsojitra,frontend/src/Assets/css/scss/style.css.map,1,2,1
8c7fc2c591d9788184169cfe6cd8a31ca4d079be,codal-jsojitra,frontend/src/Pages/Projects/AddProject/Component/addProject.jsx,187,199,12
8c7fc2c591d9788184169cfe6cd8a31ca4d079be,codal-jsojitra,frontend/src/Pages/UserProfile/Edit/Component/EditProfile.jsx,3,4,1
ed41c2e9272d31901535e5b3227cf07bb461e0a4,codal-sid,backend/rptool/views.py,1,2,1
80d346e4e3b0c56e79af0471e53a49db4c2bba77,pkiri-codal,backend/rptool/views.py,1,2,1
a5237ed06ff4fc92af46b8e2c2ee033d2b4d0b08,pkiri-codal,frontend/src/Actions/index.js,56,58,2
a5237ed06ff4fc92af46b8e2c2ee033d2b4d0b08,pkiri-codal,frontend/src/Actions/type.js,9,13,4
a5237ed06ff4fc92af46b8e2c2ee033d2b4d0b08,pkiri-codal,frontend/src/Assets/css/scss/_orgnation.scss,14,16,2
a5237ed06ff4fc92af46b8e2c2ee033d2b4d0b08,pkiri-codal,frontend/src/Assets/css/scss/_profile.scss,19,22,3
a5237ed06ff4fc92af46b8e2c2ee033d2b4d0b08,pkiri-codal,frontend/src/Assets/css/scss/style.css,21,24,3
a5237ed06ff4fc92af46b8e2c2ee033d2b4d0b08,pkiri-codal,frontend/src/Assets/css/scss/style.css.map,1,2,1
a5237ed06ff4fc92af46b8e2c2ee033d2b4d0b08,pkiri-codal,frontend/src/Pages/Organization/Component/Organization.jsx,64,69,5
a5237ed06ff4fc92af46b8e2c2ee033d2b4d0b08,pkiri-codal,frontend/src/Pages/Organization/Container/index.js,4,5,1
a5237ed06ff4fc92af46b8e2c2ee033d2b4d0b08,pkiri-codal,frontend/src/Pages/Projects/AddProject/Component/addProject.jsx,2,5,3
a5237ed06ff4fc92af46b8e2c2ee033d2b4d0b08,pkiri-codal,frontend/src/Pages/Projects/EditProject/Component/EditProject.js,2,4,2
a5237ed06ff4fc92af46b8e2c2ee033d2b4d0b08,pkiri-codal,frontend/src/Pages/Projects/ProjectDetails/Component/project.jsx,39,73,34
a5237ed06ff4fc92af46b8e2c2ee033d2b4d0b08,pkiri-codal,frontend/src/Pages/Projects/ProjectList/Component/projectList.jsx,139,149,10
a5237ed06ff4fc92af46b8e2c2ee033d2b4d0b08,pkiri-codal,frontend/src/Pages/Request/EditChangeAllocation/Component/EditAllocation.jsx,10,18,8
a5237ed06ff4fc92af46b8e2c2ee033d2b4d0b08,pkiri-codal,frontend/src/Pages/Request/EditMoveAllocation/Component/EditMoveResource.jsx,9,17,8
a5237ed06ff4fc92af46b8e2c2ee033d2b4d0b08,pkiri-codal,frontend/src/Pages/Request/EditRequest/Component/EditResource.jsx,2,4,2
a5237ed06ff4fc92af46b8e2c2ee033d2b4d0b08,pkiri-codal,frontend/src/Pages/Request/RequestList/Component/request.jsx,8,16,8
a5237ed06ff4fc92af46b8e2c2ee033d2b4d0b08,pkiri-codal,frontend/src/Pages/Request/RequestResource/Component/AddRequest/AddRequest.jsx,4,8,4
a5237ed06ff4fc92af46b8e2c2ee033d2b4d0b08,pkiri-codal,frontend/src/Pages/Request/RequestResource/Component/EditResource/Component/EditRequest.jsx,12,22,10
a5237ed06ff4fc92af46b8e2c2ee033d2b4d0b08,pkiri-codal,frontend/src/Pages/Request/RequestResource/Component/MoveResourceStep/Component/Step1.jsx,4,8,4
a5237ed06ff4fc92af46b8e2c2ee033d2b4d0b08,pkiri-codal,frontend/src/Pages/Request/RequestResource/Component/MoveResourceStep/Component/Step2.jsx,9,17,8
a5237ed06ff4fc92af46b8e2c2ee033d2b4d0b08,pkiri-codal,frontend/src/Pages/UserProfile/Edit/Component/EditProfile.jsx,65,70,5
a5237ed06ff4fc92af46b8e2c2ee033d2b4d0b08,pkiri-codal,frontend/src/Pages/UserProfile/Edit/Container/index.js,14,20,6
a5237ed06ff4fc92af46b8e2c2ee033d2b4d0b08,pkiri-codal,frontend/src/Pages/UserProfile/Profile/Component/profile.jsx,4,15,11
a5237ed06ff4fc92af46b8e2c2ee033d2b4d0b08,pkiri-codal,frontend/src/Pages/UserProfile/Profile/Container/index.js,5,7,2
a5237ed06ff4fc92af46b8e2c2ee033d2b4d0b08,pkiri-codal,frontend/src/Reducers/Organization/OrgChart.js,17,17,0
a5237ed06ff4fc92af46b8e2c2ee033d2b4d0b08,pkiri-codal,frontend/src/Reducers/Project/GetJiraLog.js,1,2,1
a5237ed06ff4fc92af46b8e2c2ee033d2b4d0b08,pkiri-codal,frontend/src/Reducers/User/GetReportTo.js,20,20,0
a5237ed06ff4fc92af46b8e2c2ee033d2b4d0b08,pkiri-codal,frontend/src/Reducers/index.js,6,7,1
962fb586654ef6a2bf006266c5a50978167128f4,codal-sid,frontend/src/Actions/index.js,56,58,2
962fb586654ef6a2bf006266c5a50978167128f4,codal-sid,frontend/src/Actions/type.js,9,13,4
962fb586654ef6a2bf006266c5a50978167128f4,codal-sid,frontend/src/Assets/css/scss/_orgnation.scss,14,16,2
962fb586654ef6a2bf006266c5a50978167128f4,codal-sid,frontend/src/Assets/css/scss/_profile.scss,19,22,3
962fb586654ef6a2bf006266c5a50978167128f4,codal-sid,frontend/src/Assets/css/scss/style.css,21,24,3
962fb586654ef6a2bf006266c5a50978167128f4,codal-sid,frontend/src/Assets/css/scss/style.css.map,1,2,1
962fb586654ef6a2bf006266c5a50978167128f4,codal-sid,frontend/src/Pages/Organization/Component/Organization.jsx,64,69,5
962fb586654ef6a2bf006266c5a50978167128f4,codal-sid,frontend/src/Pages/Organization/Container/index.js,4,5,1
962fb586654ef6a2bf006266c5a50978167128f4,codal-sid,frontend/src/Pages/Projects/AddProject/Component/addProject.jsx,2,5,3
962fb586654ef6a2bf006266c5a50978167128f4,codal-sid,frontend/src/Pages/Projects/EditProject/Component/EditProject.js,2,4,2
962fb586654ef6a2bf006266c5a50978167128f4,codal-sid,frontend/src/Pages/Projects/ProjectDetails/Component/project.jsx,39,73,34
962fb586654ef6a2bf006266c5a50978167128f4,codal-sid,frontend/src/Pages/Projects/ProjectList/Component/projectList.jsx,139,149,10
962fb586654ef6a2bf006266c5a50978167128f4,codal-sid,frontend/src/Pages/Request/EditChangeAllocation/Component/EditAllocation.jsx,10,18,8
962fb586654ef6a2bf006266c5a50978167128f4,codal-sid,frontend/src/Pages/Request/EditMoveAllocation/Component/EditMoveResource.jsx,9,17,8
962fb586654ef6a2bf006266c5a50978167128f4,codal-sid,frontend/src/Pages/Request/EditRequest/Component/EditResource.jsx,2,4,2
962fb586654ef6a2bf006266c5a50978167128f4,codal-sid,frontend/src/Pages/Request/RequestList/Component/request.jsx,8,16,8
962fb586654ef6a2bf006266c5a50978167128f4,codal-sid,frontend/src/Pages/Request/RequestResource/Component/AddRequest/AddRequest.jsx,4,8,4
962fb586654ef6a2bf006266c5a50978167128f4,codal-sid,frontend/src/Pages/Request/RequestResource/Component/EditResource/Component/EditRequest.jsx,12,22,10
962fb586654ef6a2bf006266c5a50978167128f4,codal-sid,frontend/src/Pages/Request/RequestResource/Component/MoveResourceStep/Component/Step1.jsx,4,8,4
962fb586654ef6a2bf006266c5a50978167128f4,codal-sid,frontend/src/Pages/Request/RequestResource/Component/MoveResourceStep/Component/Step2.jsx,9,17,8
962fb586654ef6a2bf006266c5a50978167128f4,codal-sid,frontend/src/Pages/UserProfile/Edit/Component/EditProfile.jsx,65,70,5
962fb586654ef6a2bf006266c5a50978167128f4,codal-sid,frontend/src/Pages/UserProfile/Edit/Container/index.js,14,20,6
962fb586654ef6a2bf006266c5a50978167128f4,codal-sid,frontend/src/Pages/UserProfile/Profile/Component/profile.jsx,4,15,11
962fb586654ef6a2bf006266c5a50978167128f4,codal-sid,frontend/src/Pages/UserProfile/Profile/Container/index.js,5,7,2
962fb586654ef6a2bf006266c5a50978167128f4,codal-sid,frontend/src/Reducers/Organization/OrgChart.js,17,17,0
962fb586654ef6a2bf006266c5a50978167128f4,codal-sid,frontend/src/Reducers/Project/GetJiraLog.js,1,2,1
962fb586654ef6a2bf006266c5a50978167128f4,codal-sid,frontend/src/Reducers/User/GetReportTo.js,20,20,0
962fb586654ef6a2bf006266c5a50978167128f4,codal-sid,frontend/src/Reducers/index.js,6,7,1
bf635087ab50d0578c53b2713056031e7d27e259,codal-jsojitra,frontend/src/Assets/css/scss/_profile.scss,19,22,3
bf635087ab50d0578c53b2713056031e7d27e259,codal-jsojitra,frontend/src/Assets/css/scss/style.css,8,11,3
bf635087ab50d0578c53b2713056031e7d27e259,codal-jsojitra,frontend/src/Assets/css/scss/style.css.map,1,2,1
bf635087ab50d0578c53b2713056031e7d27e259,codal-jsojitra,frontend/src/Pages/Projects/AddProject/Component/addProject.jsx,0,2,2
bf635087ab50d0578c53b2713056031e7d27e259,codal-jsojitra,frontend/src/Pages/UserProfile/Edit/Component/EditProfile.jsx,65,70,5
bf635087ab50d0578c53b2713056031e7d27e259,codal-jsojitra,frontend/src/Pages/UserProfile/Edit/Container/index.js,14,20,6
bf635087ab50d0578c53b2713056031e7d27e259,codal-jsojitra,frontend/src/Pages/UserProfile/Profile/Component/profile.jsx,2,21,19
bf635087ab50d0578c53b2713056031e7d27e259,codal-jsojitra,frontend/src/Pages/UserProfile/Profile/Container/index.js,2,6,4
e92d7cd7d1d7d9fb29b94a65a292543eb3de2c90,codal-jsojitra,frontend/src/Pages/Projects/ProjectList/Component/projectList.jsx,139,149,10
a8b195eadc7597f6d91ad0be9aaceab5150b3837,pkiri-codal,docker-compose.yml,6,44,38
d3c7e7a7320556bba22c9baf1c0e62cc2df5e8f3,codal-jsojitra,frontend/src/Pages/Request/EditMoveAllocation/Component/EditMoveResource.jsx,4,8,4
d3c7e7a7320556bba22c9baf1c0e62cc2df5e8f3,codal-jsojitra,frontend/src/Pages/Request/RequestList/Component/request.jsx,8,16,8
d3c7e7a7320556bba22c9baf1c0e62cc2df5e8f3,codal-jsojitra,frontend/src/Pages/Request/RequestResource/Component/MoveResourceStep/Component/Step2.jsx,1,2,1
358437ad913fe3270ee5528d2cb4fb5fd7bc5a92,codal-jsojitra,frontend/src/Actions/index.js,27,28,1
358437ad913fe3270ee5528d2cb4fb5fd7bc5a92,codal-jsojitra,frontend/src/Actions/type.js,8,12,4
358437ad913fe3270ee5528d2cb4fb5fd7bc5a92,codal-jsojitra,frontend/src/Pages/Organization/Component/Organization.jsx,9,14,5
358437ad913fe3270ee5528d2cb4fb5fd7bc5a92,codal-jsojitra,frontend/src/Pages/Organization/Container/index.js,4,5,1
358437ad913fe3270ee5528d2cb4fb5fd7bc5a92,codal-jsojitra,frontend/src/Pages/Projects/AddProject/Component/addProject.jsx,3,5,2
358437ad913fe3270ee5528d2cb4fb5fd7bc5a92,codal-jsojitra,frontend/src/Pages/Projects/EditProject/Component/EditProject.js,2,4,2
358437ad913fe3270ee5528d2cb4fb5fd7bc5a92,codal-jsojitra,frontend/src/Pages/Request/EditChangeAllocation/Component/EditAllocation.jsx,10,18,8
358437ad913fe3270ee5528d2cb4fb5fd7bc5a92,codal-jsojitra,frontend/src/Pages/Request/EditMoveAllocation/Component/EditMoveResource.jsx,7,13,6
358437ad913fe3270ee5528d2cb4fb5fd7bc5a92,codal-jsojitra,frontend/src/Pages/Request/EditRequest/Component/EditResource.jsx,2,4,2
358437ad913fe3270ee5528d2cb4fb5fd7bc5a92,codal-jsojitra,frontend/src/Pages/Request/RequestResource/Component/AddRequest/AddRequest.jsx,4,8,4
358437ad913fe3270ee5528d2cb4fb5fd7bc5a92,codal-jsojitra,frontend/src/Pages/Request/RequestResource/Component/EditResource/Component/EditRequest.jsx,12,22,10
358437ad913fe3270ee5528d2cb4fb5fd7bc5a92,codal-jsojitra,frontend/src/Pages/Request/RequestResource/Component/MoveResourceStep/Component/Step1.jsx,4,8,4
358437ad913fe3270ee5528d2cb4fb5fd7bc5a92,codal-jsojitra,frontend/src/Pages/Request/RequestResource/Component/MoveResourceStep/Component/Step2.jsx,9,17,8
358437ad913fe3270ee5528d2cb4fb5fd7bc5a92,codal-jsojitra,frontend/src/Reducers/Organization/OrgChart.js,17,17,0
358437ad913fe3270ee5528d2cb4fb5fd7bc5a92,codal-jsojitra,frontend/src/Reducers/index.js,4,5,1
2b94e80d04f959516b960df803087929be52e606,ppatelcodal,docker-compose.yml,6,44,38
c43de2a01507203e8267b751d3473fef57b1be9f,codal-ayush,docker-compose.yml,6,44,38
ab7cb239f52b1790c0adeca4b7546f4cdc706234,pkiri-codal,backend/account/serializers.py,10,13,3
ab7cb239f52b1790c0adeca4b7546f4cdc706234,pkiri-codal,backend/mainapp/celery_app.py,8,8,0
ab7cb239f52b1790c0adeca4b7546f4cdc706234,pkiri-codal,backend/mainapp/settings.py,1,2,1
ab7cb239f52b1790c0adeca4b7546f4cdc706234,pkiri-codal,backend/rptool/admin.py,17,21,4
ab7cb239f52b1790c0adeca4b7546f4cdc706234,pkiri-codal,backend/rptool/migrations/0031_jiratimesheetcredentials.py,27,27,0
ab7cb239f52b1790c0adeca4b7546f4cdc706234,pkiri-codal,backend/rptool/migrations/0032_employee_jira_account_id.py,18,18,0
ab7cb239f52b1790c0adeca4b7546f4cdc706234,pkiri-codal,backend/rptool/migrations/0033_jiratimesheetcredentials_access_token.py,18,18,0
ab7cb239f52b1790c0adeca4b7546f4cdc706234,pkiri-codal,backend/rptool/migrations/0034_employee_report_to.py,19,19,0
ab7cb239f52b1790c0adeca4b7546f4cdc706234,pkiri-codal,backend/rptool/models.py,15,15,0
ab7cb239f52b1790c0adeca4b7546f4cdc706234,pkiri-codal,backend/rptool/permissions.py,21,26,5
ab7cb239f52b1790c0adeca4b7546f4cdc706234,pkiri-codal,backend/rptool/serializers.py,23,38,15
ab7cb239f52b1790c0adeca4b7546f4cdc706234,pkiri-codal,backend/rptool/signals.py,7,8,1
ab7cb239f52b1790c0adeca4b7546f4cdc706234,pkiri-codal,backend/rptool/tasks.py,63,64,1
ab7cb239f52b1790c0adeca4b7546f4cdc706234,pkiri-codal,backend/rptool/urls.py,9,14,5
ab7cb239f52b1790c0adeca4b7546f4cdc706234,pkiri-codal,backend/rptool/views.py,206,219,13
ab7cb239f52b1790c0adeca4b7546f4cdc706234,pkiri-codal,docker-compose.yml,4,8,4
ab7cb239f52b1790c0adeca4b7546f4cdc706234,pkiri-codal,frontend/package-lock.json,277,277,0
ab7cb239f52b1790c0adeca4b7546f4cdc706234,pkiri-codal,frontend/package.json,1,1,0
ab7cb239f52b1790c0adeca4b7546f4cdc706234,pkiri-codal,frontend/src/Actions/index.js,77,78,1
ab7cb239f52b1790c0adeca4b7546f4cdc706234,pkiri-codal,frontend/src/Actions/type.js,3,3,0
ab7cb239f52b1790c0adeca4b7546f4cdc706234,pkiri-codal,frontend/src/App.js,4,8,4
ab7cb239f52b1790c0adeca4b7546f4cdc706234,pkiri-codal,frontend/src/Assets/css/scss/_orgnation.scss,71,71,0
ab7cb239f52b1790c0adeca4b7546f4cdc706234,pkiri-codal,frontend/src/Assets/css/scss/_profile.scss,62,94,32
ab7cb239f52b1790c0adeca4b7546f4cdc706234,pkiri-codal,frontend/src/Assets/css/scss/_project.scss,14,16,2
ab7cb239f52b1790c0adeca4b7546f4cdc706234,pkiri-codal,frontend/src/Assets/css/scss/_requestResource.scss,22,23,1
ab7cb239f52b1790c0adeca4b7546f4cdc706234,pkiri-codal,frontend/src/Assets/css/scss/style.css,130,130,0
ab7cb239f52b1790c0adeca4b7546f4cdc706234,pkiri-codal,frontend/src/Assets/css/scss/style.css.map,1,2,1
ab7cb239f52b1790c0adeca4b7546f4cdc706234,pkiri-codal,frontend/src/Assets/css/scss/style.scss,1,1,0
ab7cb239f52b1790c0adeca4b7546f4cdc706234,pkiri-codal,frontend/src/Pages/Common/Component/Header.jsx,13,18,5
ab7cb239f52b1790c0adeca4b7546f4cdc706234,pkiri-codal,frontend/src/Pages/Organization/Component/Organization.jsx,149,149,0
ab7cb239f52b1790c0adeca4b7546f4cdc706234,pkiri-codal,frontend/src/Pages/Organization/Container/index.js,24,24,0
ab7cb239f52b1790c0adeca4b7546f4cdc706234,pkiri-codal,frontend/src/Pages/People/Component/employee.jsx,6,8,2
ab7cb239f52b1790c0adeca4b7546f4cdc706234,pkiri-codal,frontend/src/Pages/People/Container/index.js,6,10,4
ab7cb239f52b1790c0adeca4b7546f4cdc706234,pkiri-codal,frontend/src/Pages/Projects/AddProject/Component/addProject.jsx,11,13,2
ab7cb239f52b1790c0adeca4b7546f4cdc706234,pkiri-codal,frontend/src/Pages/Projects/EditProject/Component/EditProject.js,13,16,3
ab7cb239f52b1790c0adeca4b7546f4cdc706234,pkiri-codal,frontend/src/Pages/Projects/ProjectDetails/Component/project.jsx,124,196,72
ab7cb239f52b1790c0adeca4b7546f4cdc706234,pkiri-codal,frontend/src/Pages/Projects/ProjectDetails/Container/index.js,5,6,1
ab7cb239f52b1790c0adeca4b7546f4cdc706234,pkiri-codal,frontend/src/Pages/Request/RequestResource/Component/MoveResourceStep/Component/Step1.jsx,40,80,40
ab7cb239f52b1790c0adeca4b7546f4cdc706234,pkiri-codal,frontend/src/Pages/UserProfile/Edit/Component/EditProfile.jsx,1,2,1
ab7cb239f52b1790c0adeca4b7546f4cdc706234,pkiri-codal,frontend/src/Pages/UserProfile/Profile/Component/profile.jsx,20,29,9
ab7cb239f52b1790c0adeca4b7546f4cdc706234,pkiri-codal,frontend/src/Reducers/Project/GetJiraLog.js,17,17,0
ab7cb239f52b1790c0adeca4b7546f4cdc706234,pkiri-codal,frontend/src/Reducers/index.js,3,4,1
ab7cb239f52b1790c0adeca4b7546f4cdc706234,pkiri-codal,frontend/src/common/RoleServices.js,14,19,5
b6e5b42170d5210f7fa2444abcbe9f9fb2c96311,codal-jsojitra,frontend/src/Actions/index.js,30,32,2
b6e5b42170d5210f7fa2444abcbe9f9fb2c96311,codal-jsojitra,frontend/src/Actions/type.js,1,1,0
b6e5b42170d5210f7fa2444abcbe9f9fb2c96311,codal-jsojitra,frontend/src/Pages/UserProfile/Profile/Component/profile.jsx,13,16,3
b6e5b42170d5210f7fa2444abcbe9f9fb2c96311,codal-jsojitra,frontend/src/Pages/UserProfile/Profile/Container/index.js,6,7,1
b6e5b42170d5210f7fa2444abcbe9f9fb2c96311,codal-jsojitra,frontend/src/Reducers/User/GetReportTo.js,20,20,0
b6e5b42170d5210f7fa2444abcbe9f9fb2c96311,codal-jsojitra,frontend/src/Reducers/index.js,3,4,1
00ed91b60c661bc31fbe34c14136c6f4a467d4c1,codal-sid,backend/rptool/admin.py,2,3,1
00ed91b60c661bc31fbe34c14136c6f4a467d4c1,codal-sid,backend/rptool/permissions.py,1,2,1
00ed91b60c661bc31fbe34c14136c6f4a467d4c1,codal-sid,backend/rptool/serializers.py,21,34,13
00ed91b60c661bc31fbe34c14136c6f4a467d4c1,codal-sid,backend/rptool/views.py,27,35,8
b71a469121d255354f3a5225492c0d7e88d5ec30,codal-sid,backend/rptool/admin.py,2,3,1
b71a469121d255354f3a5225492c0d7e88d5ec30,codal-sid,backend/rptool/permissions.py,1,2,1
b71a469121d255354f3a5225492c0d7e88d5ec30,codal-sid,backend/rptool/serializers.py,21,34,13
b71a469121d255354f3a5225492c0d7e88d5ec30,codal-sid,backend/rptool/views.py,27,35,8
6ca0ca8b4ec039a7c07adbc8ff1cad049bdeca73,codal-jsojitra,frontend/src/Assets/css/scss/_orgnation.scss,14,16,2
6ca0ca8b4ec039a7c07adbc8ff1cad049bdeca73,codal-jsojitra,frontend/src/Assets/css/scss/style.css,13,13,0
6ca0ca8b4ec039a7c07adbc8ff1cad049bdeca73,codal-jsojitra,frontend/src/Assets/css/scss/style.css.map,1,2,1
6ca0ca8b4ec039a7c07adbc8ff1cad049bdeca73,codal-jsojitra,frontend/src/Pages/Organization/Component/Organization.jsx,58,61,3
dacfa7383d90561bf775002a9f30ff76a5161377,codal-jsojitra,frontend/src/Pages/Projects/ProjectDetails/Component/project.jsx,39,73,34
dacfa7383d90561bf775002a9f30ff76a5161377,codal-jsojitra,frontend/src/Reducers/Project/GetJiraLog.js,1,2,1
1997dcc7ff23bda0587c3de647de06b8af5613dd,codal-sid,frontend/src/Actions/index.js,42,44,2
1997dcc7ff23bda0587c3de647de06b8af5613dd,codal-sid,frontend/src/Actions/type.js,3,3,0
1997dcc7ff23bda0587c3de647de06b8af5613dd,codal-sid,frontend/src/Pages/Projects/EditProject/Component/EditProject.js,13,16,3
1997dcc7ff23bda0587c3de647de06b8af5613dd,codal-sid,frontend/src/Pages/Projects/ProjectDetails/Component/project.jsx,120,191,71
1997dcc7ff23bda0587c3de647de06b8af5613dd,codal-sid,frontend/src/Pages/Projects/ProjectDetails/Container/index.js,5,6,1
1997dcc7ff23bda0587c3de647de06b8af5613dd,codal-sid,frontend/src/Reducers/Project/GetJiraLog.js,17,17,0
1997dcc7ff23bda0587c3de647de06b8af5613dd,codal-sid,frontend/src/Reducers/index.js,3,4,1
adacfe94216d5dee7897bdf8c65c7412ce9ac7fc,codal-jsojitra,frontend/src/Actions/index.js,42,44,2
adacfe94216d5dee7897bdf8c65c7412ce9ac7fc,codal-jsojitra,frontend/src/Actions/type.js,3,3,0
adacfe94216d5dee7897bdf8c65c7412ce9ac7fc,codal-jsojitra,frontend/src/Pages/Projects/EditProject/Component/EditProject.js,13,16,3
adacfe94216d5dee7897bdf8c65c7412ce9ac7fc,codal-jsojitra,frontend/src/Pages/Projects/ProjectDetails/Component/project.jsx,120,191,71
adacfe94216d5dee7897bdf8c65c7412ce9ac7fc,codal-jsojitra,frontend/src/Pages/Projects/ProjectDetails/Container/index.js,5,6,1
adacfe94216d5dee7897bdf8c65c7412ce9ac7fc,codal-jsojitra,frontend/src/Reducers/Project/GetJiraLog.js,17,17,0
adacfe94216d5dee7897bdf8c65c7412ce9ac7fc,codal-jsojitra,frontend/src/Reducers/index.js,3,4,1
a34f04d039ded839cbac363e380ee964e08e49de,codal-sid,docker-compose.yml,4,8,4
6887cf6a4c66a847d99f6c4369af4b46b8db3e00,codal-sid,docker-compose.yml,4,8,4
814849540888d205cbbed98af2e942ed3c41b211,codal-sid,backend/rptool/views.py,6,7,1
dafe16a09cac6e8656e93bcddbd9c9147c700a74,codal-sid,backend/rptool/views.py,6,7,1
609a131fd903ca58273e85dddac6c36bab6e76a6,codal-sid,frontend/src/Actions/index.js,36,36,0
609a131fd903ca58273e85dddac6c36bab6e76a6,codal-sid,frontend/src/App.js,2,4,2
609a131fd903ca58273e85dddac6c36bab6e76a6,codal-sid,frontend/src/Assets/css/scss/_orgnation.scss,64,80,16
609a131fd903ca58273e85dddac6c36bab6e76a6,codal-sid,frontend/src/Assets/css/scss/style.css,54,73,19
609a131fd903ca58273e85dddac6c36bab6e76a6,codal-sid,frontend/src/Assets/css/scss/style.css.map,1,2,1
609a131fd903ca58273e85dddac6c36bab6e76a6,codal-sid,frontend/src/Pages/Common/Component/Header.jsx,3,6,3
609a131fd903ca58273e85dddac6c36bab6e76a6,codal-sid,frontend/src/Pages/Organization/Component/Organization.jsx,33,69,36
609a131fd903ca58273e85dddac6c36bab6e76a6,codal-sid,frontend/src/Pages/Organization/Container/index.js,2,4,2
609a131fd903ca58273e85dddac6c36bab6e76a6,codal-sid,frontend/src/Pages/People/Component/employee.jsx,6,8,2
609a131fd903ca58273e85dddac6c36bab6e76a6,codal-sid,frontend/src/Pages/People/Container/index.js,6,10,4
609a131fd903ca58273e85dddac6c36bab6e76a6,codal-sid,frontend/src/Pages/Projects/AddProject/Component/addProject.jsx,11,13,2
6c428afbddc0a976eb8773a44967d4cbe2db69ee,codal-jsojitra,frontend/src/Actions/index.js,13,18,5
6c428afbddc0a976eb8773a44967d4cbe2db69ee,codal-jsojitra,frontend/src/Pages/People/Component/employee.jsx,6,9,3
b090ce513c5c80dfe96c09498da5b485c8cb6363,codal-jsojitra,frontend/src/Pages/Projects/AddProject/Component/addProject.jsx,11,13,2
97170dabc4f065cd55b8cc3eebe1692a5d48b955,codal-sid,backend/account/serializers.py,10,13,3
03812224da120d9bb7d837c5aeaef93ce6776d75,codal-sid,backend/account/serializers.py,1,2,1
41c0dc41b3e7f39c1faa2a32e4cc47b358495b4e,codal-sid,backend/account/serializers.py,10,13,3
908cfa8cd4df955dc1a3751bd6dcce1d8e290ae5,codal-jsojitra,frontend/src/Actions/index.js,28,28,0
908cfa8cd4df955dc1a3751bd6dcce1d8e290ae5,codal-jsojitra,frontend/src/App.js,2,4,2
908cfa8cd4df955dc1a3751bd6dcce1d8e290ae5,codal-jsojitra,frontend/src/Assets/css/scss/_orgnation.scss,64,80,16
908cfa8cd4df955dc1a3751bd6dcce1d8e290ae5,codal-jsojitra,frontend/src/Assets/css/scss/style.css,54,73,19
908cfa8cd4df955dc1a3751bd6dcce1d8e290ae5,codal-jsojitra,frontend/src/Assets/css/scss/style.css.map,1,2,1
908cfa8cd4df955dc1a3751bd6dcce1d8e290ae5,codal-jsojitra,frontend/src/Pages/Common/Component/Header.jsx,3,6,3
908cfa8cd4df955dc1a3751bd6dcce1d8e290ae5,codal-jsojitra,frontend/src/Pages/Organization/Component/Organization.jsx,33,69,36
908cfa8cd4df955dc1a3751bd6dcce1d8e290ae5,codal-jsojitra,frontend/src/Pages/Organization/Container/index.js,2,4,2
908cfa8cd4df955dc1a3751bd6dcce1d8e290ae5,codal-jsojitra,frontend/src/Pages/People/Component/employee.jsx,1,1,0
908cfa8cd4df955dc1a3751bd6dcce1d8e290ae5,codal-jsojitra,frontend/src/Pages/People/Container/index.js,6,10,4
2cab39e5f50e0c4370b52afcaf6bb9b877afea45,codal-sid,backend/rptool/tasks.py,4,7,3
2cab39e5f50e0c4370b52afcaf6bb9b877afea45,codal-sid,backend/rptool/views.py,22,43,21
dd9c2f542769d85e45b839c5f996a3e167163342,codal-sid,backend/rptool/tasks.py,4,7,3
dd9c2f542769d85e45b839c5f996a3e167163342,codal-sid,backend/rptool/views.py,22,43,21
bd43c8afcc3c6a2e80178dd39e95cfd2dd4d02f4,codal-sid,backend/rptool/views.py,1,2,1
572b6040cc70ead500ee2cc1f627c4a9cfacd664,codal-sid,backend/rptool/migrations/0034_employee_report_to.py,19,19,0
572b6040cc70ead500ee2cc1f627c4a9cfacd664,codal-sid,backend/rptool/models.py,2,2,0
8e638022d9977b6a597345ba4827d27f691e5629,codal-sid,backend/rptool/migrations/0034_employee_report_to.py,19,19,0
8e638022d9977b6a597345ba4827d27f691e5629,codal-sid,backend/rptool/models.py,2,2,0
07640d4245a645345ba2aa615ad8d506565264cf,codal-sid,backend/rptool/serializers.py,2,4,2
31f77406735b090f5ed43bf79ce9b7899e7bdb0f,codal-sid,backend/rptool/serializers.py,2,4,2
ae137f9e931846838dcfb81481700f7fa219ec0e,codal-sid,backend/mainapp/celery_app.py,8,8,0
ae137f9e931846838dcfb81481700f7fa219ec0e,codal-sid,backend/mainapp/settings.py,1,2,1
ae137f9e931846838dcfb81481700f7fa219ec0e,codal-sid,backend/rptool/admin.py,16,20,4
ae137f9e931846838dcfb81481700f7fa219ec0e,codal-sid,backend/rptool/migrations/0031_jiratimesheetcredentials.py,27,27,0
ae137f9e931846838dcfb81481700f7fa219ec0e,codal-sid,backend/rptool/migrations/0032_employee_jira_account_id.py,18,18,0
ae137f9e931846838dcfb81481700f7fa219ec0e,codal-sid,backend/rptool/migrations/0033_jiratimesheetcredentials_access_token.py,18,18,0
ae137f9e931846838dcfb81481700f7fa219ec0e,codal-sid,backend/rptool/models.py,13,13,0
ae137f9e931846838dcfb81481700f7fa219ec0e,codal-sid,backend/rptool/permissions.py,20,24,4
ae137f9e931846838dcfb81481700f7fa219ec0e,codal-sid,backend/rptool/tasks.py,62,63,1
ae137f9e931846838dcfb81481700f7fa219ec0e,codal-sid,backend/rptool/urls.py,9,14,5
ae137f9e931846838dcfb81481700f7fa219ec0e,codal-sid,backend/rptool/views.py,175,182,7
10944ea62b5e7fabd9b6eb0800256d1aa3331308,codal-sid,backend/rptool/views.py,26,30,4
68042cb35c491e43454ca613dbc9980f6efce813,codal-sid,backend/rptool/permissions.py,9,12,3
68042cb35c491e43454ca613dbc9980f6efce813,codal-sid,backend/rptool/tasks.py,2,4,2
68042cb35c491e43454ca613dbc9980f6efce813,codal-sid,backend/rptool/urls.py,6,12,6
68042cb35c491e43454ca613dbc9980f6efce813,codal-sid,backend/rptool/views.py,10,19,9
32d26ab0d85dd46dfcd0941719f6e9e2a9387655,codal-sid,frontend/package-lock.json,277,277,0
32d26ab0d85dd46dfcd0941719f6e9e2a9387655,codal-sid,frontend/package.json,1,1,0
32d26ab0d85dd46dfcd0941719f6e9e2a9387655,codal-sid,frontend/src/App.js,4,8,4
32d26ab0d85dd46dfcd0941719f6e9e2a9387655,codal-sid,frontend/src/Assets/css/scss/_orgnation.scss,23,23,0
32d26ab0d85dd46dfcd0941719f6e9e2a9387655,codal-sid,frontend/src/Assets/css/scss/_profile.scss,62,94,32
32d26ab0d85dd46dfcd0941719f6e9e2a9387655,codal-sid,frontend/src/Assets/css/scss/_project.scss,14,16,2
32d26ab0d85dd46dfcd0941719f6e9e2a9387655,codal-sid,frontend/src/Assets/css/scss/_requestResource.scss,22,23,1
32d26ab0d85dd46dfcd0941719f6e9e2a9387655,codal-sid,frontend/src/Assets/css/scss/style.css,95,95,0
32d26ab0d85dd46dfcd0941719f6e9e2a9387655,codal-sid,frontend/src/Assets/css/scss/style.css.map,1,2,1
32d26ab0d85dd46dfcd0941719f6e9e2a9387655,codal-sid,frontend/src/Assets/css/scss/style.scss,1,1,0
32d26ab0d85dd46dfcd0941719f6e9e2a9387655,codal-sid,frontend/src/Pages/Common/Component/Header.jsx,13,18,5
32d26ab0d85dd46dfcd0941719f6e9e2a9387655,codal-sid,frontend/src/Pages/Orgnation/Component/Orgnation.jsx,152,152,0
32d26ab0d85dd46dfcd0941719f6e9e2a9387655,codal-sid,frontend/src/Pages/Orgnation/Container/index.js,24,24,0
32d26ab0d85dd46dfcd0941719f6e9e2a9387655,codal-sid,frontend/src/Pages/Projects/ProjectDetails/Component/project.jsx,6,9,3
32d26ab0d85dd46dfcd0941719f6e9e2a9387655,codal-sid,frontend/src/Pages/Request/RequestResource/Component/MoveResourceStep/Component/Step1.jsx,40,80,40
32d26ab0d85dd46dfcd0941719f6e9e2a9387655,codal-sid,frontend/src/Pages/UserProfile/Edit/Component/EditProfile.jsx,1,2,1
32d26ab0d85dd46dfcd0941719f6e9e2a9387655,codal-sid,frontend/src/Pages/UserProfile/Profile/Component/profile.jsx,20,29,9
32d26ab0d85dd46dfcd0941719f6e9e2a9387655,codal-sid,frontend/src/common/RoleServices.js,14,19,5
8dd08f5b783d69f264312c521f41d1933ccf3aee,codal-sid,backend/rptool/permissions.py,9,9,0
8dd08f5b783d69f264312c521f41d1933ccf3aee,codal-sid,backend/rptool/serializers.py,6,6,0
8dd08f5b783d69f264312c521f41d1933ccf3aee,codal-sid,backend/rptool/signals.py,7,8,1
8dd08f5b783d69f264312c521f41d1933ccf3aee,codal-sid,backend/rptool/urls.py,5,6,1
8dd08f5b783d69f264312c521f41d1933ccf3aee,codal-sid,backend/rptool/views.py,12,16,4
8dd08f5b783d69f264312c521f41d1933ccf3aee,codal-sid,frontend/package-lock.json,5,5,0
8dd08f5b783d69f264312c521f41d1933ccf3aee,codal-sid,frontend/package.json,1,1,0
8dd08f5b783d69f264312c521f41d1933ccf3aee,codal-sid,frontend/src/Actions/index.js,39,43,4
8dd08f5b783d69f264312c521f41d1933ccf3aee,codal-sid,frontend/src/App.js,11,24,13
8dd08f5b783d69f264312c521f41d1933ccf3aee,codal-sid,frontend/src/Assets/css/scss/_auth.scss,88,88,0
8dd08f5b783d69f264312c521f41d1933ccf3aee,codal-sid,frontend/src/Assets/css/scss/_component.scss,17,23,6
8dd08f5b783d69f264312c521f41d1933ccf3aee,codal-sid,frontend/src/Assets/css/scss/_header.scss,58,59,1
8dd08f5b783d69f264312c521f41d1933ccf3aee,codal-sid,frontend/src/Assets/css/scss/_layout.scss,159,159,0
8dd08f5b783d69f264312c521f41d1933ccf3aee,codal-sid,frontend/src/Assets/css/scss/_profile.scss,163,202,39
8dd08f5b783d69f264312c521f41d1933ccf3aee,codal-sid,frontend/src/Assets/css/scss/_project.scss,130,131,1
8dd08f5b783d69f264312c521f41d1933ccf3aee,codal-sid,frontend/src/Assets/css/scss/_requestListing.scss,8,11,3
8dd08f5b783d69f264312c521f41d1933ccf3aee,codal-sid,frontend/src/Assets/css/scss/_requestResource.scss,153,220,67
8dd08f5b783d69f264312c521f41d1933ccf3aee,codal-sid,frontend/src/Assets/css/scss/_table.scss,38,46,8
8dd08f5b783d69f264312c521f41d1933ccf3aee,codal-sid,frontend/src/Assets/css/scss/style.css,650,708,58
8dd08f5b783d69f264312c521f41d1933ccf3aee,codal-sid,frontend/src/Assets/css/scss/style.css.map,1,2,1
8dd08f5b783d69f264312c521f41d1933ccf3aee,codal-sid,frontend/src/Pages/Common/Component/404.jsx,20,20,0
8dd08f5b783d69f264312c521f41d1933ccf3aee,codal-sid,frontend/src/Pages/Common/Component/Header.jsx,92,152,60
8dd08f5b783d69f264312c521f41d1933ccf3aee,codal-sid,frontend/src/Pages/People/Component/employee.jsx,52,102,50
8dd08f5b783d69f264312c521f41d1933ccf3aee,codal-sid,frontend/src/Pages/People/Component/people.jsx,9,20,11
8dd08f5b783d69f264312c521f41d1933ccf3aee,codal-sid,frontend/src/Pages/People/Component/upcoming.jsx,1,2,1
8dd08f5b783d69f264312c521f41d1933ccf3aee,codal-sid,frontend/src/Pages/People/Container/index.js,3,5,2
8dd08f5b783d69f264312c521f41d1933ccf3aee,codal-sid,frontend/src/Pages/Projects/AddProject/Component/addProject.jsx,20,31,11
8dd08f5b783d69f264312c521f41d1933ccf3aee,codal-sid,frontend/src/Pages/Projects/EditProject/Component/EditProject.js,15,25,10
8dd08f5b783d69f264312c521f41d1933ccf3aee,codal-sid,frontend/src/Pages/Projects/ProjectDetails/Component/project.jsx,147,291,144
8dd08f5b783d69f264312c521f41d1933ccf3aee,codal-sid,frontend/src/Pages/Projects/ProjectList/Component/projectList.jsx,141,217,76
8dd08f5b783d69f264312c521f41d1933ccf3aee,codal-sid,frontend/src/Pages/Request/EditChangeAllocation/Component/EditAllocation.jsx,28,53,25
8dd08f5b783d69f264312c521f41d1933ccf3aee,codal-sid,frontend/src/Pages/Request/EditMoveAllocation/Component/EditMoveResource.jsx,13,25,12
8dd08f5b783d69f264312c521f41d1933ccf3aee,codal-sid,frontend/src/Pages/Request/EditRequest/Component/EditResource.jsx,1,2,1
8dd08f5b783d69f264312c521f41d1933ccf3aee,codal-sid,frontend/src/Pages/Request/RequestList/Component/request.jsx,108,200,92
8dd08f5b783d69f264312c521f41d1933ccf3aee,codal-sid,frontend/src/Pages/Request/RequestResource/Component/AddRequest/AddRequest.jsx,23,47,24
8dd08f5b783d69f264312c521f41d1933ccf3aee,codal-sid,frontend/src/Pages/Request/RequestResource/Component/EditResource/Component/EditRequest.jsx,25,39,14
8dd08f5b783d69f264312c521f41d1933ccf3aee,codal-sid,frontend/src/Pages/Request/RequestResource/Component/MoveResourceStep/Component/MoveResource.jsx,13,16,3
8dd08f5b783d69f264312c521f41d1933ccf3aee,codal-sid,frontend/src/Pages/Request/RequestResource/Component/MoveResourceStep/Component/Step1.jsx,58,90,32
8dd08f5b783d69f264312c521f41d1933ccf3aee,codal-sid,frontend/src/Pages/Request/RequestResource/Component/MoveResourceStep/Component/Step2.jsx,12,22,10
8dd08f5b783d69f264312c521f41d1933ccf3aee,codal-sid,frontend/src/Pages/Request/RequestResource/Component/MoveResourceStep/Container/index.js,3,4,1
8dd08f5b783d69f264312c521f41d1933ccf3aee,codal-sid,frontend/src/Pages/Request/RequestResource/Component/RequestSubmit.jsx,82,135,53
8dd08f5b783d69f264312c521f41d1933ccf3aee,codal-sid,frontend/src/Pages/UserProfile/Edit/Component/EditProfile.jsx,24,129,105
8dd08f5b783d69f264312c521f41d1933ccf3aee,codal-sid,frontend/src/Pages/UserProfile/Profile/Component/profile.jsx,64,121,57
8dd08f5b783d69f264312c521f41d1933ccf3aee,codal-sid,frontend/src/Reducers/Project/CreateProject.js,2,4,2
8dd08f5b783d69f264312c521f41d1933ccf3aee,codal-sid,frontend/src/common/PrivateRoute.js,0,14,14
8dd08f5b783d69f264312c521f41d1933ccf3aee,codal-sid,frontend/src/common/RoleServices.js,33,33,0
82e2aaa4ea0347d0b2db17edac572456df9d861d,codal-sid,backend/mainapp/celery_app.py,4,4,0
82e2aaa4ea0347d0b2db17edac572456df9d861d,codal-sid,backend/mainapp/settings.py,1,2,1
82e2aaa4ea0347d0b2db17edac572456df9d861d,codal-sid,backend/rptool/admin.py,14,17,3
82e2aaa4ea0347d0b2db17edac572456df9d861d,codal-sid,backend/rptool/migrations/0033_jiratimesheetcredentials_access_token.py,18,18,0
82e2aaa4ea0347d0b2db17edac572456df9d861d,codal-sid,backend/rptool/models.py,1,1,0
82e2aaa4ea0347d0b2db17edac572456df9d861d,codal-sid,backend/rptool/permissions.py,8,8,0
82e2aaa4ea0347d0b2db17edac572456df9d861d,codal-sid,backend/rptool/tasks.py,34,34,0
82e2aaa4ea0347d0b2db17edac572456df9d861d,codal-sid,backend/rptool/urls.py,8,14,6
82e2aaa4ea0347d0b2db17edac572456df9d861d,codal-sid,backend/rptool/views.py,148,151,3
34b33076de9f52768befd52326de3bf0a9b6e7a9,codal-jsojitra,frontend/package-lock.json,277,277,0
34b33076de9f52768befd52326de3bf0a9b6e7a9,codal-jsojitra,frontend/package.json,1,1,0
34b33076de9f52768befd52326de3bf0a9b6e7a9,codal-jsojitra,frontend/src/App.js,4,8,4
34b33076de9f52768befd52326de3bf0a9b6e7a9,codal-jsojitra,frontend/src/Assets/css/scss/_orgnation.scss,23,23,0
34b33076de9f52768befd52326de3bf0a9b6e7a9,codal-jsojitra,frontend/src/Assets/css/scss/_profile.scss,52,87,35
34b33076de9f52768befd52326de3bf0a9b6e7a9,codal-jsojitra,frontend/src/Assets/css/scss/_project.scss,6,10,4
34b33076de9f52768befd52326de3bf0a9b6e7a9,codal-jsojitra,frontend/src/Assets/css/scss/_requestResource.scss,22,23,1
34b33076de9f52768befd52326de3bf0a9b6e7a9,codal-jsojitra,frontend/src/Assets/css/scss/style.css,77,77,0
34b33076de9f52768befd52326de3bf0a9b6e7a9,codal-jsojitra,frontend/src/Assets/css/scss/style.css.map,1,2,1
34b33076de9f52768befd52326de3bf0a9b6e7a9,codal-jsojitra,frontend/src/Assets/css/scss/style.scss,1,1,0
34b33076de9f52768befd52326de3bf0a9b6e7a9,codal-jsojitra,frontend/src/Pages/Common/Component/Header.jsx,13,18,5
34b33076de9f52768befd52326de3bf0a9b6e7a9,codal-jsojitra,frontend/src/Pages/Orgnation/Component/Orgnation.jsx,152,152,0
34b33076de9f52768befd52326de3bf0a9b6e7a9,codal-jsojitra,frontend/src/Pages/Orgnation/Container/index.js,24,24,0
34b33076de9f52768befd52326de3bf0a9b6e7a9,codal-jsojitra,frontend/src/Pages/Projects/ProjectDetails/Component/project.jsx,1,2,1
34b33076de9f52768befd52326de3bf0a9b6e7a9,codal-jsojitra,frontend/src/Pages/Request/RequestResource/Component/MoveResourceStep/Component/Step1.jsx,40,80,40
34b33076de9f52768befd52326de3bf0a9b6e7a9,codal-jsojitra,frontend/src/Pages/UserProfile/Edit/Component/EditProfile.jsx,1,2,1
34b33076de9f52768befd52326de3bf0a9b6e7a9,codal-jsojitra,frontend/src/Pages/UserProfile/Profile/Component/profile.jsx,19,27,8
2248336cc625baf2b6f13e41d77575524ce59107,codal-sid,backend/rptool/signals.py,7,8,1
e138e9fddec644405078afbf37aa99a0821e5bd6,sshaikhcodal,backend/rptool/signals.py,7,8,1
cc92ef678eb5aa1c8ab460cff2592a6be76b1674,codal-jsojitra,frontend/src/common/RoleServices.js,14,19,5
34df7755887ff615e598d3b8e01153033fd94818,pkiri-codal,backend/rptool/views.py,2,3,1
34df7755887ff615e598d3b8e01153033fd94818,pkiri-codal,frontend/src/Actions/index.js,37,42,5
34df7755887ff615e598d3b8e01153033fd94818,pkiri-codal,frontend/src/App.js,1,2,1
34df7755887ff615e598d3b8e01153033fd94818,pkiri-codal,frontend/src/Assets/css/scss/_auth.scss,88,88,0
34df7755887ff615e598d3b8e01153033fd94818,pkiri-codal,frontend/src/Assets/css/scss/_header.scss,54,59,5
34df7755887ff615e598d3b8e01153033fd94818,pkiri-codal,frontend/src/Assets/css/scss/_layout.scss,36,48,12
34df7755887ff615e598d3b8e01153033fd94818,pkiri-codal,frontend/src/Assets/css/scss/_profile.scss,110,111,1
34df7755887ff615e598d3b8e01153033fd94818,pkiri-codal,frontend/src/Assets/css/scss/_project.scss,111,114,3
34df7755887ff615e598d3b8e01153033fd94818,pkiri-codal,frontend/src/Assets/css/scss/_requestListing.scss,5,13,8
34df7755887ff615e598d3b8e01153033fd94818,pkiri-codal,frontend/src/Assets/css/scss/style.css,344,363,19
34df7755887ff615e598d3b8e01153033fd94818,pkiri-codal,frontend/src/Assets/css/scss/style.css.map,1,2,1
34df7755887ff615e598d3b8e01153033fd94818,pkiri-codal,frontend/src/Pages/Common/Component/404.jsx,0,0,0
34df7755887ff615e598d3b8e01153033fd94818,pkiri-codal,frontend/src/Pages/Common/Component/Header.jsx,44,62,18
34df7755887ff615e598d3b8e01153033fd94818,pkiri-codal,frontend/src/Pages/People/Component/employee.jsx,40,64,24
34df7755887ff615e598d3b8e01153033fd94818,pkiri-codal,frontend/src/Pages/People/Container/index.js,2,4,2
34df7755887ff615e598d3b8e01153033fd94818,pkiri-codal,frontend/src/Pages/Projects/AddProject/Component/addProject.jsx,5,8,3
34df7755887ff615e598d3b8e01153033fd94818,pkiri-codal,frontend/src/Pages/Projects/ProjectDetails/Component/project.jsx,16,27,11
34df7755887ff615e598d3b8e01153033fd94818,pkiri-codal,frontend/src/Pages/Request/RequestResource/Component/AddRequest/AddRequest.jsx,7,14,7
34df7755887ff615e598d3b8e01153033fd94818,pkiri-codal,frontend/src/Pages/UserProfile/Edit/Component/EditProfile.jsx,13,109,96
34df7755887ff615e598d3b8e01153033fd94818,pkiri-codal,frontend/src/Pages/UserProfile/Profile/Component/profile.jsx,15,31,16
61ae6489cde40921ef5f500f931e80e378b80144,codal-sid,backend/rptool/views.py,2,3,1
849de9e9ade5520f552e1c0ca5cae1939305957b,sshaikhcodal,backend/rptool/views.py,2,3,1
bede745e7bc9fd4673231cb8ed8135381012f943,codal-jsojitra,frontend/src/Assets/css/scss/_profile.scss,13,13,0
bede745e7bc9fd4673231cb8ed8135381012f943,codal-jsojitra,frontend/src/Assets/css/scss/_project.scss,10,10,0
bede745e7bc9fd4673231cb8ed8135381012f943,codal-jsojitra,frontend/src/Assets/css/scss/style.css,18,18,0
bede745e7bc9fd4673231cb8ed8135381012f943,codal-jsojitra,frontend/src/Assets/css/scss/style.css.map,1,2,1
bede745e7bc9fd4673231cb8ed8135381012f943,codal-jsojitra,frontend/src/Pages/Projects/ProjectDetails/Component/project.jsx,5,7,2
bede745e7bc9fd4673231cb8ed8135381012f943,codal-jsojitra,frontend/src/Pages/UserProfile/Profile/Component/profile.jsx,1,2,1
281757b31a867332dfab3bc2e7b0e39f008c9a15,codal-sid,frontend/src/Actions/index.js,37,42,5
281757b31a867332dfab3bc2e7b0e39f008c9a15,codal-sid,frontend/src/App.js,1,2,1
281757b31a867332dfab3bc2e7b0e39f008c9a15,codal-sid,frontend/src/Assets/css/scss/_auth.scss,88,88,0
281757b31a867332dfab3bc2e7b0e39f008c9a15,codal-sid,frontend/src/Assets/css/scss/_header.scss,54,59,5
281757b31a867332dfab3bc2e7b0e39f008c9a15,codal-sid,frontend/src/Assets/css/scss/_layout.scss,36,48,12
281757b31a867332dfab3bc2e7b0e39f008c9a15,codal-sid,frontend/src/Assets/css/scss/_profile.scss,110,111,1
281757b31a867332dfab3bc2e7b0e39f008c9a15,codal-sid,frontend/src/Assets/css/scss/_project.scss,111,114,3
281757b31a867332dfab3bc2e7b0e39f008c9a15,codal-sid,frontend/src/Assets/css/scss/_requestListing.scss,5,13,8
281757b31a867332dfab3bc2e7b0e39f008c9a15,codal-sid,frontend/src/Assets/css/scss/style.css,344,363,19
281757b31a867332dfab3bc2e7b0e39f008c9a15,codal-sid,frontend/src/Assets/css/scss/style.css.map,1,2,1
281757b31a867332dfab3bc2e7b0e39f008c9a15,codal-sid,frontend/src/Pages/Common/Component/404.jsx,0,0,0
281757b31a867332dfab3bc2e7b0e39f008c9a15,codal-sid,frontend/src/Pages/Common/Component/Header.jsx,44,62,18
281757b31a867332dfab3bc2e7b0e39f008c9a15,codal-sid,frontend/src/Pages/People/Component/employee.jsx,40,64,24
281757b31a867332dfab3bc2e7b0e39f008c9a15,codal-sid,frontend/src/Pages/People/Container/index.js,2,4,2
281757b31a867332dfab3bc2e7b0e39f008c9a15,codal-sid,frontend/src/Pages/Projects/AddProject/Component/addProject.jsx,5,8,3
281757b31a867332dfab3bc2e7b0e39f008c9a15,codal-sid,frontend/src/Pages/Projects/ProjectDetails/Component/project.jsx,16,27,11
281757b31a867332dfab3bc2e7b0e39f008c9a15,codal-sid,frontend/src/Pages/Request/RequestResource/Component/AddRequest/AddRequest.jsx,7,14,7
281757b31a867332dfab3bc2e7b0e39f008c9a15,codal-sid,frontend/src/Pages/UserProfile/Edit/Component/EditProfile.jsx,13,109,96
281757b31a867332dfab3bc2e7b0e39f008c9a15,codal-sid,frontend/src/Pages/UserProfile/Profile/Component/profile.jsx,15,31,16
871189b633ca6c4648afa91b81b090e66dc04ffb,codal-jsojitra,frontend/src/Pages/UserProfile/Profile/Component/profile.jsx,14,29,15
8d6c891e47c50f6714b627ab2c6383e351697c8a,codal-jsojitra,frontend/src/Pages/Common/Component/Header.jsx,1,2,1
eeb803d2b49037812c4b09c4827b0e3d68348e19,codal-jsojitra,frontend/src/Assets/css/scss/_project.scss,16,21,5
eeb803d2b49037812c4b09c4827b0e3d68348e19,codal-jsojitra,frontend/src/Assets/css/scss/style.css,30,41,11
eeb803d2b49037812c4b09c4827b0e3d68348e19,codal-jsojitra,frontend/src/Assets/css/scss/style.css.map,1,2,1
7f5f223fdd42c459e5d4866abcb0434d34b95d96,codal-jsojitra,frontend/src/Assets/css/scss/_layout.scss,2,3,1
7f5f223fdd42c459e5d4866abcb0434d34b95d96,codal-jsojitra,frontend/src/Assets/css/scss/_profile.scss,66,66,0
7f5f223fdd42c459e5d4866abcb0434d34b95d96,codal-jsojitra,frontend/src/Assets/css/scss/style.css,54,55,1
7f5f223fdd42c459e5d4866abcb0434d34b95d96,codal-jsojitra,frontend/src/Assets/css/scss/style.css.map,1,2,1
7f5f223fdd42c459e5d4866abcb0434d34b95d96,codal-jsojitra,frontend/src/Pages/Common/Component/Header.jsx,1,2,1
7f5f223fdd42c459e5d4866abcb0434d34b95d96,codal-jsojitra,frontend/src/Pages/Projects/AddProject/Component/addProject.jsx,5,8,3
8f1ad3e6adc97874c2203f606d1f5d797bf901de,codal-jsojitra,frontend/src/Assets/css/scss/_header.scss,52,56,4
8f1ad3e6adc97874c2203f606d1f5d797bf901de,codal-jsojitra,frontend/src/Assets/css/scss/_profile.scss,44,45,1
8f1ad3e6adc97874c2203f606d1f5d797bf901de,codal-jsojitra,frontend/src/Assets/css/scss/_project.scss,100,103,3
8f1ad3e6adc97874c2203f606d1f5d797bf901de,codal-jsojitra,frontend/src/Assets/css/scss/style.css,158,162,4
8f1ad3e6adc97874c2203f606d1f5d797bf901de,codal-jsojitra,frontend/src/Assets/css/scss/style.css.map,1,2,1
8f1ad3e6adc97874c2203f606d1f5d797bf901de,codal-jsojitra,frontend/src/Pages/Common/Component/Header.jsx,17,26,9
8f1ad3e6adc97874c2203f606d1f5d797bf901de,codal-jsojitra,frontend/src/Pages/Projects/ProjectDetails/Component/project.jsx,4,10,6
8f1ad3e6adc97874c2203f606d1f5d797bf901de,codal-jsojitra,frontend/src/Pages/UserProfile/Profile/Component/profile.jsx,1,2,1
c6b284096900387160a72ecbaaeeb4f837e07d5d,codal-jsojitra,frontend/src/Actions/index.js,36,40,4
c6b284096900387160a72ecbaaeeb4f837e07d5d,codal-jsojitra,frontend/src/Assets/css/scss/_auth.scss,88,88,0
c6b284096900387160a72ecbaaeeb4f837e07d5d,codal-jsojitra,frontend/src/Assets/css/scss/_requestListing.scss,5,13,8
c6b284096900387160a72ecbaaeeb4f837e07d5d,codal-jsojitra,frontend/src/Assets/css/scss/style.css,76,83,7
c6b284096900387160a72ecbaaeeb4f837e07d5d,codal-jsojitra,frontend/src/Assets/css/scss/style.css.map,1,2,1
c6b284096900387160a72ecbaaeeb4f837e07d5d,codal-jsojitra,frontend/src/Pages/Common/Component/Header.jsx,3,8,5
c6b284096900387160a72ecbaaeeb4f837e07d5d,codal-jsojitra,frontend/src/Pages/People/Component/employee.jsx,40,64,24
c6b284096900387160a72ecbaaeeb4f837e07d5d,codal-jsojitra,frontend/src/Pages/People/Container/index.js,2,4,2
937975d28ab94a619144fa624dbe45cf1af75a52,pkiri-codal,backend/rptool/urls.py,1,2,1
80d0a3cbd5891a84e751b3a64a3893a44ae6c512,codal-sid,backend/rptool/urls.py,1,2,1
eeabfa7b428b90c4945c27ea53386249696c33b8,sshaikhcodal,backend/rptool/urls.py,1,2,1
fa762f0899d4fc7d47e16be5968b3c715ee20714,pkiri-codal,backend/rptool/permissions.py,7,7,0
fa762f0899d4fc7d47e16be5968b3c715ee20714,pkiri-codal,backend/rptool/serializers.py,6,6,0
fa762f0899d4fc7d47e16be5968b3c715ee20714,pkiri-codal,backend/rptool/urls.py,3,4,1
fa762f0899d4fc7d47e16be5968b3c715ee20714,pkiri-codal,backend/rptool/views.py,9,11,2
fa762f0899d4fc7d47e16be5968b3c715ee20714,pkiri-codal,frontend/src/Assets/css/scss/_header.scss,8,8,0
fa762f0899d4fc7d47e16be5968b3c715ee20714,pkiri-codal,frontend/src/Assets/css/scss/_layout.scss,45,46,1
fa762f0899d4fc7d47e16be5968b3c715ee20714,pkiri-codal,frontend/src/Assets/css/scss/_profile.scss,54,93,39
fa762f0899d4fc7d47e16be5968b3c715ee20714,pkiri-codal,frontend/src/Assets/css/scss/_project.scss,22,23,1
fa762f0899d4fc7d47e16be5968b3c715ee20714,pkiri-codal,frontend/src/Assets/css/scss/_requestListing.scss,12,16,4
fa762f0899d4fc7d47e16be5968b3c715ee20714,pkiri-codal,frontend/src/Assets/css/scss/_requestResource.scss,87,93,6
fa762f0899d4fc7d47e16be5968b3c715ee20714,pkiri-codal,frontend/src/Assets/css/scss/style.css,175,207,32
fa762f0899d4fc7d47e16be5968b3c715ee20714,pkiri-codal,frontend/src/Assets/css/scss/style.css.map,1,2,1
fa762f0899d4fc7d47e16be5968b3c715ee20714,pkiri-codal,frontend/src/Pages/People/Component/employee.jsx,12,38,26
fa762f0899d4fc7d47e16be5968b3c715ee20714,pkiri-codal,frontend/src/Pages/People/Component/upcoming.jsx,1,2,1
fa762f0899d4fc7d47e16be5968b3c715ee20714,pkiri-codal,frontend/src/Pages/People/Container/index.js,1,1,0
fa762f0899d4fc7d47e16be5968b3c715ee20714,pkiri-codal,frontend/src/Pages/Projects/ProjectDetails/Component/project.jsx,13,26,13
fa762f0899d4fc7d47e16be5968b3c715ee20714,pkiri-codal,frontend/src/Pages/Projects/ProjectList/Component/projectList.jsx,65,86,21
fa762f0899d4fc7d47e16be5968b3c715ee20714,pkiri-codal,frontend/src/Pages/Request/EditChangeAllocation/Component/EditAllocation.jsx,1,2,1
fa762f0899d4fc7d47e16be5968b3c715ee20714,pkiri-codal,frontend/src/Pages/Request/EditMoveAllocation/Component/EditMoveResource.jsx,1,2,1
fa762f0899d4fc7d47e16be5968b3c715ee20714,pkiri-codal,frontend/src/Pages/Request/RequestList/Component/request.jsx,5,10,5
fa762f0899d4fc7d47e16be5968b3c715ee20714,pkiri-codal,frontend/src/Pages/Request/RequestResource/Component/AddRequest/AddRequest.jsx,11,26,15
fa762f0899d4fc7d47e16be5968b3c715ee20714,pkiri-codal,frontend/src/Pages/Request/RequestResource/Component/EditResource/Component/EditRequest.jsx,1,2,1
fa762f0899d4fc7d47e16be5968b3c715ee20714,pkiri-codal,frontend/src/Pages/Request/RequestResource/Component/MoveResourceStep/Component/Step1.jsx,12,35,23
fa762f0899d4fc7d47e16be5968b3c715ee20714,pkiri-codal,frontend/src/Pages/Request/RequestResource/Component/MoveResourceStep/Component/Step2.jsx,1,2,1
fa762f0899d4fc7d47e16be5968b3c715ee20714,pkiri-codal,frontend/src/Pages/UserProfile/Edit/Component/EditProfile.jsx,17,32,15
fa762f0899d4fc7d47e16be5968b3c715ee20714,pkiri-codal,frontend/src/Pages/UserProfile/Profile/Component/profile.jsx,2,4,2
e52889fd73580023ee0fda01d9f1605f642b35a3,codal-jsojitra,frontend/src/App.js,1,2,1
e52889fd73580023ee0fda01d9f1605f642b35a3,codal-jsojitra,frontend/src/Assets/css/scss/_header.scss,2,3,1
e52889fd73580023ee0fda01d9f1605f642b35a3,codal-jsojitra,frontend/src/Assets/css/scss/_layout.scss,34,45,11
e52889fd73580023ee0fda01d9f1605f642b35a3,codal-jsojitra,frontend/src/Assets/css/scss/style.css,37,44,7
e52889fd73580023ee0fda01d9f1605f642b35a3,codal-jsojitra,frontend/src/Assets/css/scss/style.css.map,1,2,1
e52889fd73580023ee0fda01d9f1605f642b35a3,codal-jsojitra,frontend/src/Pages/Common/Component/404.jsx,0,0,0
e52889fd73580023ee0fda01d9f1605f642b35a3,codal-jsojitra,frontend/src/Pages/Common/Component/Header.jsx,38,56,18
e52889fd73580023ee0fda01d9f1605f642b35a3,codal-jsojitra,frontend/src/Pages/UserProfile/Edit/Component/EditProfile.jsx,13,109,96
376844d11626dc4cdb90272a2b487541ef1c337c,codal-sid,backend/rptool/permissions.py,7,7,0
376844d11626dc4cdb90272a2b487541ef1c337c,codal-sid,backend/rptool/serializers.py,6,6,0
376844d11626dc4cdb90272a2b487541ef1c337c,codal-sid,backend/rptool/urls.py,3,4,1
376844d11626dc4cdb90272a2b487541ef1c337c,codal-sid,backend/rptool/views.py,9,11,2
8ad7ed66cec1c7ff5256d98b75cf3403c44e3199,sshaikhcodal,backend/rptool/serializers.py,1,2,1
585460631390bf64642fcd67c9bc9e8f73b6bfba,sshaikhcodal,backend/rptool/permissions.py,3,8,5
585460631390bf64642fcd67c9bc9e8f73b6bfba,sshaikhcodal,backend/rptool/serializers.py,1,2,1
f79e4e172db5f182515f2e2d47509e8c49a4415b,sshaikhcodal,backend/rptool/permissions.py,9,9,0
f79e4e172db5f182515f2e2d47509e8c49a4415b,sshaikhcodal,backend/rptool/serializers.py,6,6,0
f79e4e172db5f182515f2e2d47509e8c49a4415b,sshaikhcodal,backend/rptool/urls.py,3,4,1
f79e4e172db5f182515f2e2d47509e8c49a4415b,sshaikhcodal,backend/rptool/views.py,9,11,2
4cd0eeb5fd27f3712d4b4a5b7e3ca21b517d36f9,codal-jsojitra,frontend/src/Actions/index.js,1,2,1
4cd0eeb5fd27f3712d4b4a5b7e3ca21b517d36f9,codal-jsojitra,frontend/src/Pages/Projects/ProjectDetails/Component/project.jsx,12,17,5
4cd0eeb5fd27f3712d4b4a5b7e3ca21b517d36f9,codal-jsojitra,frontend/src/Pages/Request/RequestResource/Component/AddRequest/AddRequest.jsx,7,14,7
449a303ab78f8744bc7eabd53b781f4e4588a6c3,codal-sid,frontend/src/Assets/css/scss/_header.scss,8,8,0
449a303ab78f8744bc7eabd53b781f4e4588a6c3,codal-sid,frontend/src/Assets/css/scss/_layout.scss,45,46,1
449a303ab78f8744bc7eabd53b781f4e4588a6c3,codal-sid,frontend/src/Assets/css/scss/_profile.scss,54,93,39
449a303ab78f8744bc7eabd53b781f4e4588a6c3,codal-sid,frontend/src/Assets/css/scss/_project.scss,12,12,0
449a303ab78f8744bc7eabd53b781f4e4588a6c3,codal-sid,frontend/src/Assets/css/scss/_requestListing.scss,11,15,4
449a303ab78f8744bc7eabd53b781f4e4588a6c3,codal-sid,frontend/src/Assets/css/scss/_requestResource.scss,87,93,6
449a303ab78f8744bc7eabd53b781f4e4588a6c3,codal-sid,frontend/src/Assets/css/scss/style.css,171,203,32
449a303ab78f8744bc7eabd53b781f4e4588a6c3,codal-sid,frontend/src/Assets/css/scss/style.css.map,1,2,1
449a303ab78f8744bc7eabd53b781f4e4588a6c3,codal-sid,frontend/src/Pages/Projects/ProjectDetails/Component/project.jsx,13,26,13
449a303ab78f8744bc7eabd53b781f4e4588a6c3,codal-sid,frontend/src/Pages/Projects/ProjectList/Component/projectList.jsx,1,2,1
449a303ab78f8744bc7eabd53b781f4e4588a6c3,codal-sid,frontend/src/Pages/Request/EditChangeAllocation/Component/EditAllocation.jsx,1,2,1
449a303ab78f8744bc7eabd53b781f4e4588a6c3,codal-sid,frontend/src/Pages/Request/EditMoveAllocation/Component/EditMoveResource.jsx,1,2,1
449a303ab78f8744bc7eabd53b781f4e4588a6c3,codal-sid,frontend/src/Pages/Request/RequestList/Component/request.jsx,1,2,1
449a303ab78f8744bc7eabd53b781f4e4588a6c3,codal-sid,frontend/src/Pages/Request/RequestResource/Component/AddRequest/AddRequest.jsx,4,13,9
449a303ab78f8744bc7eabd53b781f4e4588a6c3,codal-sid,frontend/src/Pages/Request/RequestResource/Component/EditResource/Component/EditRequest.jsx,1,2,1
449a303ab78f8744bc7eabd53b781f4e4588a6c3,codal-sid,frontend/src/Pages/Request/RequestResource/Component/MoveResourceStep/Component/Step1.jsx,12,35,23
449a303ab78f8744bc7eabd53b781f4e4588a6c3,codal-sid,frontend/src/Pages/Request/RequestResource/Component/MoveResourceStep/Component/Step2.jsx,1,2,1
449a303ab78f8744bc7eabd53b781f4e4588a6c3,codal-sid,frontend/src/Pages/UserProfile/Edit/Component/EditProfile.jsx,17,32,15
449a303ab78f8744bc7eabd53b781f4e4588a6c3,codal-sid,frontend/src/Pages/UserProfile/Profile/Component/profile.jsx,2,4,2
ca516ae291dc00964b3e761fdaeeaba690382e59,codal-jsojitra,frontend/src/Assets/css/scss/_header.scss,8,8,0
ca516ae291dc00964b3e761fdaeeaba690382e59,codal-jsojitra,frontend/src/Assets/css/scss/_layout.scss,45,46,1
ca516ae291dc00964b3e761fdaeeaba690382e59,codal-jsojitra,frontend/src/Assets/css/scss/_profile.scss,54,93,39
ca516ae291dc00964b3e761fdaeeaba690382e59,codal-jsojitra,frontend/src/Assets/css/scss/_project.scss,12,12,0
ca516ae291dc00964b3e761fdaeeaba690382e59,codal-jsojitra,frontend/src/Assets/css/scss/_requestListing.scss,11,15,4
ca516ae291dc00964b3e761fdaeeaba690382e59,codal-jsojitra,frontend/src/Assets/css/scss/style.css,104,136,32
ca516ae291dc00964b3e761fdaeeaba690382e59,codal-jsojitra,frontend/src/Assets/css/scss/style.css.map,1,2,1
ca516ae291dc00964b3e761fdaeeaba690382e59,codal-jsojitra,frontend/src/Pages/Projects/ProjectDetails/Component/project.jsx,13,26,13
ca516ae291dc00964b3e761fdaeeaba690382e59,codal-jsojitra,frontend/src/Pages/Projects/ProjectList/Component/projectList.jsx,1,2,1
ca516ae291dc00964b3e761fdaeeaba690382e59,codal-jsojitra,frontend/src/Pages/Request/RequestList/Component/request.jsx,1,2,1
ca516ae291dc00964b3e761fdaeeaba690382e59,codal-jsojitra,frontend/src/Pages/UserProfile/Profile/Component/profile.jsx,2,4,2
6535281d7a70ff0271513fec00bd527fe2c254c0,codal-jsojitra,frontend/src/Assets/css/scss/_requestResource.scss,87,93,6
6535281d7a70ff0271513fec00bd527fe2c254c0,codal-jsojitra,frontend/src/Assets/css/scss/style.css,67,67,0
6535281d7a70ff0271513fec00bd527fe2c254c0,codal-jsojitra,frontend/src/Assets/css/scss/style.css.map,1,2,1
6535281d7a70ff0271513fec00bd527fe2c254c0,codal-jsojitra,frontend/src/Pages/Request/EditChangeAllocation/Component/EditAllocation.jsx,1,2,1
6535281d7a70ff0271513fec00bd527fe2c254c0,codal-jsojitra,frontend/src/Pages/Request/EditMoveAllocation/Component/EditMoveResource.jsx,1,2,1
6535281d7a70ff0271513fec00bd527fe2c254c0,codal-jsojitra,frontend/src/Pages/Request/RequestResource/Component/AddRequest/AddRequest.jsx,4,13,9
6535281d7a70ff0271513fec00bd527fe2c254c0,codal-jsojitra,frontend/src/Pages/Request/RequestResource/Component/EditResource/Component/EditRequest.jsx,1,2,1
6535281d7a70ff0271513fec00bd527fe2c254c0,codal-jsojitra,frontend/src/Pages/Request/RequestResource/Component/MoveResourceStep/Component/Step1.jsx,12,35,23
6535281d7a70ff0271513fec00bd527fe2c254c0,codal-jsojitra,frontend/src/Pages/Request/RequestResource/Component/MoveResourceStep/Component/Step2.jsx,1,2,1
6535281d7a70ff0271513fec00bd527fe2c254c0,codal-jsojitra,frontend/src/Pages/UserProfile/Edit/Component/EditProfile.jsx,17,32,15
3d4293c8b0007d5acc3feb7ac1c48d9a6371aa7e,codal-sid,frontend/src/Assets/css/scss/_project.scss,10,11,1
3d4293c8b0007d5acc3feb7ac1c48d9a6371aa7e,codal-sid,frontend/src/Assets/css/scss/_requestListing.scss,1,1,0
3d4293c8b0007d5acc3feb7ac1c48d9a6371aa7e,codal-sid,frontend/src/Assets/css/scss/style.css,4,4,0
3d4293c8b0007d5acc3feb7ac1c48d9a6371aa7e,codal-sid,frontend/src/Assets/css/scss/style.css.map,1,2,1
3d4293c8b0007d5acc3feb7ac1c48d9a6371aa7e,codal-sid,frontend/src/Pages/People/Component/employee.jsx,12,38,26
3d4293c8b0007d5acc3feb7ac1c48d9a6371aa7e,codal-sid,frontend/src/Pages/People/Component/upcoming.jsx,1,2,1
3d4293c8b0007d5acc3feb7ac1c48d9a6371aa7e,codal-sid,frontend/src/Pages/People/Container/index.js,1,1,0
3d4293c8b0007d5acc3feb7ac1c48d9a6371aa7e,codal-sid,frontend/src/Pages/Projects/ProjectList/Component/projectList.jsx,64,84,20
3d4293c8b0007d5acc3feb7ac1c48d9a6371aa7e,codal-sid,frontend/src/Pages/Request/RequestList/Component/request.jsx,4,8,4
3d4293c8b0007d5acc3feb7ac1c48d9a6371aa7e,codal-sid,frontend/src/Pages/Request/RequestResource/Component/AddRequest/AddRequest.jsx,7,13,6
f040d6a6ffa09ab35ebf4a89e0eb2758f088aa9b,codal-sid,backend/rptool/migrations/0031_jiratimesheetcredentials.py,27,27,0
f040d6a6ffa09ab35ebf4a89e0eb2758f088aa9b,codal-sid,backend/rptool/migrations/0032_employee_jira_account_id.py,18,18,0
e9a91c2682b93966b0c5aaa9a151ce70de24c3a5,codal-sid,backend/mainapp/celery_app.py,4,4,0
e9a91c2682b93966b0c5aaa9a151ce70de24c3a5,codal-sid,backend/rptool/admin.py,3,5,2
e9a91c2682b93966b0c5aaa9a151ce70de24c3a5,codal-sid,backend/rptool/models.py,12,12,0
e9a91c2682b93966b0c5aaa9a151ce70de24c3a5,codal-sid,backend/rptool/tasks.py,28,29,1
295dcf2b79503358555789c45ed028287d18fc41,codal-jsojitra,frontend/src/Assets/css/scss/_project.scss,3,4,1
295dcf2b79503358555789c45ed028287d18fc41,codal-jsojitra,frontend/src/Assets/css/scss/style.css,1,2,1
295dcf2b79503358555789c45ed028287d18fc41,codal-jsojitra,frontend/src/Assets/css/scss/style.css.map,1,2,1
295dcf2b79503358555789c45ed028287d18fc41,codal-jsojitra,frontend/src/Pages/Projects/ProjectList/Component/projectList.jsx,5,8,3
3ebf0e009d862c876842d1c786349a1a25fc9143,codal-jsojitra,frontend/src/Assets/css/scss/_project.scss,8,9,1
3ebf0e009d862c876842d1c786349a1a25fc9143,codal-jsojitra,frontend/src/Assets/css/scss/style.css,3,3,0
3ebf0e009d862c876842d1c786349a1a25fc9143,codal-jsojitra,frontend/src/Assets/css/scss/style.css.map,1,2,1
3ebf0e009d862c876842d1c786349a1a25fc9143,codal-jsojitra,frontend/src/Pages/People/Component/employee.jsx,11,16,5
3ebf0e009d862c876842d1c786349a1a25fc9143,codal-jsojitra,frontend/src/Pages/People/Container/index.js,1,1,0
3ebf0e009d862c876842d1c786349a1a25fc9143,codal-jsojitra,frontend/src/Pages/Projects/ProjectList/Component/projectList.jsx,60,78,18
4201580f0ad8948990fc20c8a75c72a92e288ca1,codal-jsojitra,frontend/src/Pages/People/Component/employee.jsx,1,22,21
4201580f0ad8948990fc20c8a75c72a92e288ca1,codal-jsojitra,frontend/src/Pages/People/Component/upcoming.jsx,1,2,1
4201580f0ad8948990fc20c8a75c72a92e288ca1,codal-jsojitra,frontend/src/Pages/Projects/ProjectList/Component/projectList.jsx,2,4,2
4201580f0ad8948990fc20c8a75c72a92e288ca1,codal-jsojitra,frontend/src/Pages/Request/RequestList/Component/request.jsx,4,8,4
1a1c702433268a27eda230e043cd04579b9297a7,codal-jsojitra,frontend/src/Assets/css/scss/_requestListing.scss,1,1,0
1a1c702433268a27eda230e043cd04579b9297a7,codal-jsojitra,frontend/src/Assets/css/scss/style.css,1,1,0
1a1c702433268a27eda230e043cd04579b9297a7,codal-jsojitra,frontend/src/Assets/css/scss/style.css.map,1,2,1
1a1c702433268a27eda230e043cd04579b9297a7,codal-jsojitra,frontend/src/Pages/Request/RequestResource/Component/AddRequest/AddRequest.jsx,7,13,6
9f613ba52936eb70e3e5d9cc842271c1ab8417be,pkiri-codal,frontend/package-lock.json,5,5,0
9f613ba52936eb70e3e5d9cc842271c1ab8417be,pkiri-codal,frontend/package.json,1,1,0
9f613ba52936eb70e3e5d9cc842271c1ab8417be,pkiri-codal,frontend/src/Actions/index.js,3,3,0
9f613ba52936eb70e3e5d9cc842271c1ab8417be,pkiri-codal,frontend/src/App.js,11,24,13
9f613ba52936eb70e3e5d9cc842271c1ab8417be,pkiri-codal,frontend/src/Assets/css/scss/_component.scss,17,23,6
9f613ba52936eb70e3e5d9cc842271c1ab8417be,pkiri-codal,frontend/src/Assets/css/scss/_layout.scss,91,91,0
9f613ba52936eb70e3e5d9cc842271c1ab8417be,pkiri-codal,frontend/src/Assets/css/scss/_table.scss,38,46,8
9f613ba52936eb70e3e5d9cc842271c1ab8417be,pkiri-codal,frontend/src/Assets/css/scss/style.css,108,109,1
9f613ba52936eb70e3e5d9cc842271c1ab8417be,pkiri-codal,frontend/src/Assets/css/scss/style.css.map,1,2,1
9f613ba52936eb70e3e5d9cc842271c1ab8417be,pkiri-codal,frontend/src/Pages/Common/Component/Header.jsx,46,86,40
9f613ba52936eb70e3e5d9cc842271c1ab8417be,pkiri-codal,frontend/src/Pages/Common/Component/notfound.jsx,20,20,0
9f613ba52936eb70e3e5d9cc842271c1ab8417be,pkiri-codal,frontend/src/Pages/People/Component/people.jsx,9,20,11
9f613ba52936eb70e3e5d9cc842271c1ab8417be,pkiri-codal,frontend/src/Pages/Projects/AddProject/Component/addProject.jsx,16,25,9
9f613ba52936eb70e3e5d9cc842271c1ab8417be,pkiri-codal,frontend/src/Pages/Projects/EditProject/Component/EditProject.js,15,25,10
9f613ba52936eb70e3e5d9cc842271c1ab8417be,pkiri-codal,frontend/src/Pages/Projects/ProjectDetails/Component/project.jsx,119,240,121
9f613ba52936eb70e3e5d9cc842271c1ab8417be,pkiri-codal,frontend/src/Pages/Projects/ProjectList/Component/projectList.jsx,80,139,59
9f613ba52936eb70e3e5d9cc842271c1ab8417be,pkiri-codal,frontend/src/Pages/Request/EditChangeAllocation/Component/EditAllocation.jsx,1,2,1
9f613ba52936eb70e3e5d9cc842271c1ab8417be,pkiri-codal,frontend/src/Pages/Request/EditMoveAllocation/Component/EditMoveResource.jsx,2,4,2
9f613ba52936eb70e3e5d9cc842271c1ab8417be,pkiri-codal,frontend/src/Pages/Request/EditRequest/Component/EditResource.jsx,1,2,1
9f613ba52936eb70e3e5d9cc842271c1ab8417be,pkiri-codal,frontend/src/Pages/Request/RequestList/Component/request.jsx,106,196,90
9f613ba52936eb70e3e5d9cc842271c1ab8417be,pkiri-codal,frontend/src/Pages/Request/RequestResource/Component/AddRequest/AddRequest.jsx,6,9,3
9f613ba52936eb70e3e5d9cc842271c1ab8417be,pkiri-codal,frontend/src/Pages/Request/RequestResource/Component/EditResource/Component/EditRequest.jsx,2,4,2
9f613ba52936eb70e3e5d9cc842271c1ab8417be,pkiri-codal,frontend/src/Pages/Request/RequestResource/Component/MoveResourceStep/Component/Step1.jsx,21,32,11
9f613ba52936eb70e3e5d9cc842271c1ab8417be,pkiri-codal,frontend/src/Pages/Request/RequestResource/Component/RequestSubmit.jsx,64,114,50
9f613ba52936eb70e3e5d9cc842271c1ab8417be,pkiri-codal,frontend/src/Pages/UserProfile/Profile/Component/profile.jsx,47,86,39
9f613ba52936eb70e3e5d9cc842271c1ab8417be,pkiri-codal,frontend/src/common/PrivateRoute.js,0,14,14
9f613ba52936eb70e3e5d9cc842271c1ab8417be,pkiri-codal,frontend/src/common/RoleServices.js,33,33,0
e2ef749b342d96ff7f05ff4397f370d83abae3c4,codal-sid,frontend/package-lock.json,5,5,0
e2ef749b342d96ff7f05ff4397f370d83abae3c4,codal-sid,frontend/package.json,1,1,0
e2ef749b342d96ff7f05ff4397f370d83abae3c4,codal-sid,frontend/src/Actions/index.js,3,3,0
e2ef749b342d96ff7f05ff4397f370d83abae3c4,codal-sid,frontend/src/App.js,9,21,12
e2ef749b342d96ff7f05ff4397f370d83abae3c4,codal-sid,frontend/src/Assets/css/scss/_component.scss,17,23,6
e2ef749b342d96ff7f05ff4397f370d83abae3c4,codal-sid,frontend/src/Assets/css/scss/style.css,12,13,1
e2ef749b342d96ff7f05ff4397f370d83abae3c4,codal-sid,frontend/src/Assets/css/scss/style.css.map,1,2,1
e2ef749b342d96ff7f05ff4397f370d83abae3c4,codal-sid,frontend/src/Pages/Common/Component/Header.jsx,46,86,40
e2ef749b342d96ff7f05ff4397f370d83abae3c4,codal-sid,frontend/src/Pages/People/Component/people.jsx,9,20,11
e2ef749b342d96ff7f05ff4397f370d83abae3c4,codal-sid,frontend/src/Pages/Projects/AddProject/Component/addProject.jsx,15,23,8
e2ef749b342d96ff7f05ff4397f370d83abae3c4,codal-sid,frontend/src/Pages/Projects/EditProject/Component/EditProject.js,15,25,10
e2ef749b342d96ff7f05ff4397f370d83abae3c4,codal-sid,frontend/src/Pages/Projects/ProjectDetails/Component/project.jsx,118,238,120
e2ef749b342d96ff7f05ff4397f370d83abae3c4,codal-sid,frontend/src/Pages/Projects/ProjectList/Component/projectList.jsx,80,139,59
e2ef749b342d96ff7f05ff4397f370d83abae3c4,codal-sid,frontend/src/Pages/Request/RequestList/Component/request.jsx,62,112,50
e2ef749b342d96ff7f05ff4397f370d83abae3c4,codal-sid,frontend/src/Pages/Request/RequestResource/Component/RequestSubmit.jsx,39,75,36
e2ef749b342d96ff7f05ff4397f370d83abae3c4,codal-sid,frontend/src/Pages/UserProfile/Profile/Component/profile.jsx,35,60,25
e2ef749b342d96ff7f05ff4397f370d83abae3c4,codal-sid,frontend/src/common/PrivateRoute.js,0,14,14
e2ef749b342d96ff7f05ff4397f370d83abae3c4,codal-sid,frontend/src/common/RoleServices.js,33,33,0
c5dc0365f544e5c77696d2a2d8980cb735d8d1f8,codal-jsojitra,frontend/src/Pages/People/Component/people.jsx,4,10,6
c5dc0365f544e5c77696d2a2d8980cb735d8d1f8,codal-jsojitra,frontend/src/Pages/Projects/AddProject/Component/addProject.jsx,3,3,0
c5dc0365f544e5c77696d2a2d8980cb735d8d1f8,codal-jsojitra,frontend/src/Pages/Request/RequestList/Component/request.jsx,51,95,44
c5dc0365f544e5c77696d2a2d8980cb735d8d1f8,codal-jsojitra,frontend/src/Pages/Request/RequestResource/Component/RequestSubmit.jsx,3,3,0
3ae05c25ad67199343eaad11c48f94aebd64d37a,codal-jsojitra,frontend/src/Pages/Common/Component/Header.jsx,3,4,1
3ae05c25ad67199343eaad11c48f94aebd64d37a,codal-jsojitra,frontend/src/Pages/Projects/ProjectList/Component/projectList.jsx,1,2,1
de65218ad740fc0ad77fa3af7bbf52897dee8d5a,codal-jsojitra,frontend/package-lock.json,5,5,0
de65218ad740fc0ad77fa3af7bbf52897dee8d5a,codal-jsojitra,frontend/package.json,1,1,0
de65218ad740fc0ad77fa3af7bbf52897dee8d5a,codal-jsojitra,frontend/src/Actions/index.js,3,4,1
de65218ad740fc0ad77fa3af7bbf52897dee8d5a,codal-jsojitra,frontend/src/App.js,7,18,11
de65218ad740fc0ad77fa3af7bbf52897dee8d5a,codal-jsojitra,frontend/src/Pages/People/Component/people.jsx,9,18,9
de65218ad740fc0ad77fa3af7bbf52897dee8d5a,codal-jsojitra,frontend/src/Pages/Projects/AddProject/Component/addProject.jsx,12,20,8
de65218ad740fc0ad77fa3af7bbf52897dee8d5a,codal-jsojitra,frontend/src/Pages/Projects/EditProject/Component/EditProject.js,15,25,10
de65218ad740fc0ad77fa3af7bbf52897dee8d5a,codal-jsojitra,frontend/src/Pages/Request/RequestResource/Component/RequestSubmit.jsx,37,81,44
de65218ad740fc0ad77fa3af7bbf52897dee8d5a,codal-jsojitra,frontend/src/common/RoleServices.js,18,21,3
1768a68c4b33e85c949175af8f4f1e6df5b8d967,codal-jsojitra,frontend/src/Assets/css/scss/_component.scss,17,23,6
1768a68c4b33e85c949175af8f4f1e6df5b8d967,codal-jsojitra,frontend/src/Assets/css/scss/style.css,12,13,1
1768a68c4b33e85c949175af8f4f1e6df5b8d967,codal-jsojitra,frontend/src/Assets/css/scss/style.css.map,1,2,1
1768a68c4b33e85c949175af8f4f1e6df5b8d967,codal-jsojitra,frontend/src/Pages/Request/RequestList/Component/request.jsx,3,3,0
e939f9db652b485c3450403e1d71be4468d24447,codal-jsojitra,frontend/src/Pages/Projects/ProjectList/Component/projectList.jsx,1,5,4
e939f9db652b485c3450403e1d71be4468d24447,codal-jsojitra,frontend/src/Pages/Request/RequestResource/Component/RequestSubmit.jsx,10,13,3
0d6f3a3ea2b6fad08cbf0910b8f18c013b52928d,codal-jsojitra,frontend/src/Pages/Projects/ProjectList/Component/projectList.jsx,28,46,18
b51141f36568c9df540b8a20537ad3ef2f13ab0a,codal-jsojitra,frontend/src/Actions/index.js,1,1,0
b51141f36568c9df540b8a20537ad3ef2f13ab0a,codal-jsojitra,frontend/src/App.js,4,7,3
b51141f36568c9df540b8a20537ad3ef2f13ab0a,codal-jsojitra,frontend/src/Pages/Common/Component/Header.jsx,43,82,39
b51141f36568c9df540b8a20537ad3ef2f13ab0a,codal-jsojitra,frontend/src/Pages/Projects/ProjectDetails/Component/project.jsx,118,238,120
b51141f36568c9df540b8a20537ad3ef2f13ab0a,codal-jsojitra,frontend/src/Pages/Projects/ProjectList/Component/projectList.jsx,67,120,53
b51141f36568c9df540b8a20537ad3ef2f13ab0a,codal-jsojitra,frontend/src/Pages/Request/RequestList/Component/request.jsx,8,14,6
b51141f36568c9df540b8a20537ad3ef2f13ab0a,codal-jsojitra,frontend/src/Pages/UserProfile/Profile/Component/profile.jsx,35,60,25
b51141f36568c9df540b8a20537ad3ef2f13ab0a,codal-jsojitra,frontend/src/common/PrivateRoute.js,0,14,14
b51141f36568c9df540b8a20537ad3ef2f13ab0a,codal-jsojitra,frontend/src/common/RoleServices.js,18,18,0
f943de4576b65e79bea6311ee219f78a03eecf44,codal-sid,frontend/src/App.js,2,3,1
f943de4576b65e79bea6311ee219f78a03eecf44,codal-sid,frontend/src/Assets/css/scss/_layout.scss,91,91,0
f943de4576b65e79bea6311ee219f78a03eecf44,codal-sid,frontend/src/Assets/css/scss/_table.scss,38,46,8
f943de4576b65e79bea6311ee219f78a03eecf44,codal-sid,frontend/src/Assets/css/scss/style.css,96,96,0
f943de4576b65e79bea6311ee219f78a03eecf44,codal-sid,frontend/src/Assets/css/scss/style.css.map,1,2,1
f943de4576b65e79bea6311ee219f78a03eecf44,codal-sid,frontend/src/Pages/Common/Component/notfound.jsx,20,20,0
f943de4576b65e79bea6311ee219f78a03eecf44,codal-sid,frontend/src/Pages/Projects/AddProject/Component/addProject.jsx,1,2,1
f943de4576b65e79bea6311ee219f78a03eecf44,codal-sid,frontend/src/Pages/Projects/EditProject/Component/EditProject.js,1,2,1
f943de4576b65e79bea6311ee219f78a03eecf44,codal-sid,frontend/src/Pages/Projects/ProjectDetails/Component/project.jsx,2,4,2
f943de4576b65e79bea6311ee219f78a03eecf44,codal-sid,frontend/src/Pages/Request/EditChangeAllocation/Component/EditAllocation.jsx,1,2,1
f943de4576b65e79bea6311ee219f78a03eecf44,codal-sid,frontend/src/Pages/Request/EditMoveAllocation/Component/EditMoveResource.jsx,2,4,2
f943de4576b65e79bea6311ee219f78a03eecf44,codal-sid,frontend/src/Pages/Request/EditRequest/Component/EditResource.jsx,1,2,1
f943de4576b65e79bea6311ee219f78a03eecf44,codal-sid,frontend/src/Pages/Request/RequestList/Component/request.jsx,48,92,44
f943de4576b65e79bea6311ee219f78a03eecf44,codal-sid,frontend/src/Pages/Request/RequestResource/Component/AddRequest/AddRequest.jsx,6,9,3
f943de4576b65e79bea6311ee219f78a03eecf44,codal-sid,frontend/src/Pages/Request/RequestResource/Component/EditResource/Component/EditRequest.jsx,2,4,2
f943de4576b65e79bea6311ee219f78a03eecf44,codal-sid,frontend/src/Pages/Request/RequestResource/Component/MoveResourceStep/Component/Step1.jsx,21,32,11
f943de4576b65e79bea6311ee219f78a03eecf44,codal-sid,frontend/src/Pages/Request/RequestResource/Component/RequestSubmit.jsx,39,67,28
f943de4576b65e79bea6311ee219f78a03eecf44,codal-sid,frontend/src/Pages/UserProfile/Profile/Component/profile.jsx,12,26,14
82f38411ca05d783bacdcd1a2c3858f232c4f31e,codal-jsojitra,frontend/src/App.js,2,3,1
82f38411ca05d783bacdcd1a2c3858f232c4f31e,codal-jsojitra,frontend/src/Assets/css/scss/_layout.scss,91,91,0
82f38411ca05d783bacdcd1a2c3858f232c4f31e,codal-jsojitra,frontend/src/Assets/css/scss/style.css,83,83,0
82f38411ca05d783bacdcd1a2c3858f232c4f31e,codal-jsojitra,frontend/src/Assets/css/scss/style.css.map,1,2,1
82f38411ca05d783bacdcd1a2c3858f232c4f31e,codal-jsojitra,frontend/src/Pages/Common/Component/notfound.jsx,20,20,0
3b2a129258ee89a09078e1355699041149d7033a,codal-jsojitra,frontend/src/Pages/Request/RequestList/Component/request.jsx,40,83,43
3b2a129258ee89a09078e1355699041149d7033a,codal-jsojitra,frontend/src/Pages/UserProfile/Profile/Component/profile.jsx,2,9,7
c41d787b8db0a2e08f824b554381b5cc93bb3878,codal-jsojitra,frontend/src/Pages/Projects/ProjectDetails/Component/project.jsx,2,4,2
c41d787b8db0a2e08f824b554381b5cc93bb3878,codal-jsojitra,frontend/src/Pages/Request/RequestList/Component/request.jsx,14,21,7
c41d787b8db0a2e08f824b554381b5cc93bb3878,codal-jsojitra,frontend/src/Pages/Request/RequestResource/Component/MoveResourceStep/Component/Step1.jsx,21,32,11
c41d787b8db0a2e08f824b554381b5cc93bb3878,codal-jsojitra,frontend/src/Pages/Request/RequestResource/Component/RequestSubmit.jsx,39,67,28
c41d787b8db0a2e08f824b554381b5cc93bb3878,codal-jsojitra,frontend/src/Pages/UserProfile/Profile/Component/profile.jsx,10,17,7
0a86766084973300735bf16fc400e18748f16a86,pkiri-codal,backend/rptool/admin.py,2,4,2
0a86766084973300735bf16fc400e18748f16a86,pkiri-codal,backend/rptool/migrations/0029_auto_20200406_1328.py,23,23,0
0a86766084973300735bf16fc400e18748f16a86,pkiri-codal,backend/rptool/migrations/0030_employeeproject_temp_end_date.py,18,18,0
0a86766084973300735bf16fc400e18748f16a86,pkiri-codal,backend/rptool/models.py,2,2,0
0a86766084973300735bf16fc400e18748f16a86,pkiri-codal,backend/rptool/serializers.py,23,27,4
0a86766084973300735bf16fc400e18748f16a86,pkiri-codal,backend/rptool/signals.py,10,13,3
0a86766084973300735bf16fc400e18748f16a86,pkiri-codal,frontend/src/Assets/css/scss/_requestResource.scss,72,139,67
0a86766084973300735bf16fc400e18748f16a86,pkiri-codal,frontend/src/Assets/css/scss/style.css,41,65,24
0a86766084973300735bf16fc400e18748f16a86,pkiri-codal,frontend/src/Assets/css/scss/style.css.map,1,2,1
0a86766084973300735bf16fc400e18748f16a86,pkiri-codal,frontend/src/Pages/Common/Component/Header.jsx,2,4,2
0a86766084973300735bf16fc400e18748f16a86,pkiri-codal,frontend/src/Pages/People/Component/employee.jsx,1,2,1
0a86766084973300735bf16fc400e18748f16a86,pkiri-codal,frontend/src/Pages/Request/EditChangeAllocation/Component/EditAllocation.jsx,26,49,23
0a86766084973300735bf16fc400e18748f16a86,pkiri-codal,frontend/src/Pages/Request/EditMoveAllocation/Component/EditMoveResource.jsx,10,19,9
0a86766084973300735bf16fc400e18748f16a86,pkiri-codal,frontend/src/Pages/Request/RequestResource/Component/EditResource/Component/EditRequest.jsx,22,33,11
0a86766084973300735bf16fc400e18748f16a86,pkiri-codal,frontend/src/Pages/Request/RequestResource/Component/MoveResourceStep/Component/MoveResource.jsx,13,16,3
0a86766084973300735bf16fc400e18748f16a86,pkiri-codal,frontend/src/Pages/Request/RequestResource/Component/MoveResourceStep/Component/Step1.jsx,34,41,7
0a86766084973300735bf16fc400e18748f16a86,pkiri-codal,frontend/src/Pages/Request/RequestResource/Component/MoveResourceStep/Component/Step2.jsx,11,20,9
0a86766084973300735bf16fc400e18748f16a86,pkiri-codal,frontend/src/Pages/Request/RequestResource/Component/MoveResourceStep/Container/index.js,3,4,1
0a86766084973300735bf16fc400e18748f16a86,pkiri-codal,frontend/src/Pages/Request/RequestResource/Component/RequestSubmit.jsx,22,29,7
0a86766084973300735bf16fc400e18748f16a86,pkiri-codal,frontend/src/Reducers/Project/CreateProject.js,2,4,2
b6ff3a18d423e311f753f991426b06b9c6be9f77,codal-jsojitra,frontend/src/Assets/css/scss/_table.scss,38,46,8
b6ff3a18d423e311f753f991426b06b9c6be9f77,codal-jsojitra,frontend/src/Assets/css/scss/style.css,13,13,0
b6ff3a18d423e311f753f991426b06b9c6be9f77,codal-jsojitra,frontend/src/Assets/css/scss/style.css.map,1,2,1
5e7d30cc9ad365bbaa970d391db0866e1ed6234e,codal-jsojitra,frontend/src/Pages/Projects/AddProject/Component/addProject.jsx,1,2,1
5e7d30cc9ad365bbaa970d391db0866e1ed6234e,codal-jsojitra,frontend/src/Pages/Projects/EditProject/Component/EditProject.js,1,2,1
5e7d30cc9ad365bbaa970d391db0866e1ed6234e,codal-jsojitra,frontend/src/Pages/Request/EditChangeAllocation/Component/EditAllocation.jsx,1,2,1
5e7d30cc9ad365bbaa970d391db0866e1ed6234e,codal-jsojitra,frontend/src/Pages/Request/EditMoveAllocation/Component/EditMoveResource.jsx,2,4,2
5e7d30cc9ad365bbaa970d391db0866e1ed6234e,codal-jsojitra,frontend/src/Pages/Request/EditRequest/Component/EditResource.jsx,1,2,1
5e7d30cc9ad365bbaa970d391db0866e1ed6234e,codal-jsojitra,frontend/src/Pages/Request/RequestResource/Component/AddRequest/AddRequest.jsx,6,9,3
5e7d30cc9ad365bbaa970d391db0866e1ed6234e,codal-jsojitra,frontend/src/Pages/Request/RequestResource/Component/EditResource/Component/EditRequest.jsx,2,4,2
890a48213dd3d3b77bf85dfb7cbf491997b5588f,codal-sid,frontend/src/Pages/Request/EditChangeAllocation/Component/EditAllocation.jsx,19,35,16
890a48213dd3d3b77bf85dfb7cbf491997b5588f,codal-sid,frontend/src/Pages/Request/EditMoveAllocation/Component/EditMoveResource.jsx,8,15,7
890a48213dd3d3b77bf85dfb7cbf491997b5588f,codal-sid,frontend/src/Pages/Request/RequestResource/Component/EditResource/Component/EditRequest.jsx,17,23,6
890a48213dd3d3b77bf85dfb7cbf491997b5588f,codal-sid,frontend/src/Pages/Request/RequestResource/Component/MoveResourceStep/Component/MoveResource.jsx,7,14,7
890a48213dd3d3b77bf85dfb7cbf491997b5588f,codal-sid,frontend/src/Pages/Request/RequestResource/Component/MoveResourceStep/Component/Step2.jsx,4,8,4
6d54ee81d49defa10bf8fe5fcb8812f5acbc2888,codal-jsojitra,frontend/src/Pages/Request/EditChangeAllocation/Component/EditAllocation.jsx,19,35,16
6d54ee81d49defa10bf8fe5fcb8812f5acbc2888,codal-jsojitra,frontend/src/Pages/Request/EditMoveAllocation/Component/EditMoveResource.jsx,8,15,7
6d54ee81d49defa10bf8fe5fcb8812f5acbc2888,codal-jsojitra,frontend/src/Pages/Request/RequestResource/Component/EditResource/Component/EditRequest.jsx,17,23,6
6d54ee81d49defa10bf8fe5fcb8812f5acbc2888,codal-jsojitra,frontend/src/Pages/Request/RequestResource/Component/MoveResourceStep/Component/MoveResource.jsx,7,14,7
6d54ee81d49defa10bf8fe5fcb8812f5acbc2888,codal-jsojitra,frontend/src/Pages/Request/RequestResource/Component/MoveResourceStep/Component/Step2.jsx,4,8,4
a2e78ed5e4114283ae49f15ab983a9c011036578,codal-sid,frontend/src/Assets/css/scss/_requestResource.scss,72,139,67
a2e78ed5e4114283ae49f15ab983a9c011036578,codal-sid,frontend/src/Assets/css/scss/style.css,41,65,24
a2e78ed5e4114283ae49f15ab983a9c011036578,codal-sid,frontend/src/Assets/css/scss/style.css.map,1,2,1
a2e78ed5e4114283ae49f15ab983a9c011036578,codal-sid,frontend/src/Pages/Common/Component/Header.jsx,2,4,2
a2e78ed5e4114283ae49f15ab983a9c011036578,codal-sid,frontend/src/Pages/People/Component/employee.jsx,1,2,1
a2e78ed5e4114283ae49f15ab983a9c011036578,codal-sid,frontend/src/Pages/Request/EditChangeAllocation/Component/EditAllocation.jsx,7,14,7
a2e78ed5e4114283ae49f15ab983a9c011036578,codal-sid,frontend/src/Pages/Request/EditMoveAllocation/Component/EditMoveResource.jsx,2,4,2
a2e78ed5e4114283ae49f15ab983a9c011036578,codal-sid,frontend/src/Pages/Request/RequestResource/Component/EditResource/Component/EditRequest.jsx,5,10,5
a2e78ed5e4114283ae49f15ab983a9c011036578,codal-sid,frontend/src/Pages/Request/RequestResource/Component/MoveResourceStep/Component/MoveResource.jsx,11,12,1
a2e78ed5e4114283ae49f15ab983a9c011036578,codal-sid,frontend/src/Pages/Request/RequestResource/Component/MoveResourceStep/Component/Step1.jsx,34,41,7
a2e78ed5e4114283ae49f15ab983a9c011036578,codal-sid,frontend/src/Pages/Request/RequestResource/Component/MoveResourceStep/Component/Step2.jsx,8,14,6
a2e78ed5e4114283ae49f15ab983a9c011036578,codal-sid,frontend/src/Pages/Request/RequestResource/Component/MoveResourceStep/Container/index.js,3,4,1
a2e78ed5e4114283ae49f15ab983a9c011036578,codal-sid,frontend/src/Pages/Request/RequestResource/Component/RequestSubmit.jsx,22,29,7
a2e78ed5e4114283ae49f15ab983a9c011036578,codal-sid,frontend/src/Reducers/Project/CreateProject.js,2,4,2
c9c228004552a9ac4688b9c4c03b901d141ca0fb,codal-jsojitra,frontend/src/Pages/Request/RequestResource/Component/MoveResourceStep/Component/Step2.jsx,2,2,0
031bb7782c581c83f88131ff2e51acc3f90c86f5,codal-jsojitra,frontend/src/Pages/Request/RequestResource/Component/MoveResourceStep/Component/Step1.jsx,15,19,4
031bb7782c581c83f88131ff2e51acc3f90c86f5,codal-jsojitra,frontend/src/Pages/Request/RequestResource/Component/RequestSubmit.jsx,5,9,4
031bb7782c581c83f88131ff2e51acc3f90c86f5,codal-jsojitra,frontend/src/Reducers/Project/CreateProject.js,2,4,2
00ba61a94014f1475ef30875003320eab52086a1,codal-sid,backend/rptool/admin.py,2,4,2
00ba61a94014f1475ef30875003320eab52086a1,codal-sid,backend/rptool/migrations/0029_auto_20200406_1328.py,23,23,0
00ba61a94014f1475ef30875003320eab52086a1,codal-sid,backend/rptool/migrations/0030_employeeproject_temp_end_date.py,18,18,0
00ba61a94014f1475ef30875003320eab52086a1,codal-sid,backend/rptool/models.py,2,2,0
00ba61a94014f1475ef30875003320eab52086a1,codal-sid,backend/rptool/serializers.py,23,27,4
00ba61a94014f1475ef30875003320eab52086a1,codal-sid,backend/rptool/signals.py,10,13,3
2913de1e142885c41b0c02fc4093d27208bdb629,codal-sid,backend/rptool/admin.py,2,4,2
2913de1e142885c41b0c02fc4093d27208bdb629,codal-sid,backend/rptool/migrations/0029_auto_20200406_1328.py,23,23,0
2913de1e142885c41b0c02fc4093d27208bdb629,codal-sid,backend/rptool/migrations/0030_employeeproject_temp_end_date.py,18,18,0
2913de1e142885c41b0c02fc4093d27208bdb629,codal-sid,backend/rptool/models.py,2,2,0
2913de1e142885c41b0c02fc4093d27208bdb629,codal-sid,backend/rptool/serializers.py,23,27,4
2913de1e142885c41b0c02fc4093d27208bdb629,codal-sid,backend/rptool/signals.py,10,13,3
e903e99a7518ed0ca18aea9fd1056a42348e7607,codal-jsojitra,frontend/src/Pages/Request/RequestResource/Component/MoveResourceStep/Component/MoveResource.jsx,6,6,0
e903e99a7518ed0ca18aea9fd1056a42348e7607,codal-jsojitra,frontend/src/Pages/Request/RequestResource/Component/MoveResourceStep/Component/Step1.jsx,16,23,7
e903e99a7518ed0ca18aea9fd1056a42348e7607,codal-jsojitra,frontend/src/Pages/Request/RequestResource/Component/RequestSubmit.jsx,6,10,4
331a1d6142de77cd03ecf19693f7963dc27679c6,codal-jsojitra,frontend/src/Pages/Request/RequestResource/Component/MoveResourceStep/Component/MoveResource.jsx,5,6,1
331a1d6142de77cd03ecf19693f7963dc27679c6,codal-jsojitra,frontend/src/Pages/Request/RequestResource/Component/MoveResourceStep/Component/Step1.jsx,2,4,2
331a1d6142de77cd03ecf19693f7963dc27679c6,codal-jsojitra,frontend/src/Pages/Request/RequestResource/Component/MoveResourceStep/Container/index.js,3,4,1
331a1d6142de77cd03ecf19693f7963dc27679c6,codal-jsojitra,frontend/src/Pages/Request/RequestResource/Component/RequestSubmit.jsx,17,22,5
6c9f02aa4ae7c76937a163c7da8878fe6a0df5a9,codal-jsojitra,frontend/src/Assets/css/scss/_requestResource.scss,6,11,5
6c9f02aa4ae7c76937a163c7da8878fe6a0df5a9,codal-jsojitra,frontend/src/Assets/css/scss/style.css,9,9,0
6c9f02aa4ae7c76937a163c7da8878fe6a0df5a9,codal-jsojitra,frontend/src/Assets/css/scss/style.css.map,1,2,1
6c9f02aa4ae7c76937a163c7da8878fe6a0df5a9,codal-jsojitra,frontend/src/Pages/Request/EditChangeAllocation/Component/EditAllocation.jsx,7,14,7
6c9f02aa4ae7c76937a163c7da8878fe6a0df5a9,codal-jsojitra,frontend/src/Pages/Request/EditMoveAllocation/Component/EditMoveResource.jsx,2,4,2
6c9f02aa4ae7c76937a163c7da8878fe6a0df5a9,codal-jsojitra,frontend/src/Pages/Request/RequestResource/Component/EditResource/Component/EditRequest.jsx,5,10,5
6c9f02aa4ae7c76937a163c7da8878fe6a0df5a9,codal-jsojitra,frontend/src/Pages/Request/RequestResource/Component/MoveResourceStep/Component/Step2.jsx,6,12,6
789ad6559ff736bb7019761b14bfe3eee926fb9d,codal-jsojitra,frontend/src/Assets/css/scss/_requestResource.scss,71,138,67
789ad6559ff736bb7019761b14bfe3eee926fb9d,codal-jsojitra,frontend/src/Assets/css/scss/style.css,32,56,24
789ad6559ff736bb7019761b14bfe3eee926fb9d,codal-jsojitra,frontend/src/Assets/css/scss/style.css.map,1,2,1
789ad6559ff736bb7019761b14bfe3eee926fb9d,codal-jsojitra,frontend/src/Pages/Common/Component/Header.jsx,2,4,2
789ad6559ff736bb7019761b14bfe3eee926fb9d,codal-jsojitra,frontend/src/Pages/People/Component/employee.jsx,1,2,1
789ad6559ff736bb7019761b14bfe3eee926fb9d,codal-jsojitra,frontend/src/Pages/Request/RequestResource/Component/MoveResourceStep/Component/Step1.jsx,8,9,1
ee6834b461cb44ed9005958ad1e7957822bb5550,pkiri-codal,backend/docker/config/nginx/conf.d/local.conf,7,100,93
ee6834b461cb44ed9005958ad1e7957822bb5550,pkiri-codal,backend/rptool/migrations/0028_employee_is_future_employee.py,18,18,0
ee6834b461cb44ed9005958ad1e7957822bb5550,pkiri-codal,backend/rptool/models.py,2,3,1
ee6834b461cb44ed9005958ad1e7957822bb5550,pkiri-codal,backend/rptool/serializers.py,37,49,12
ee6834b461cb44ed9005958ad1e7957822bb5550,pkiri-codal,backend/rptool/signals.py,65,131,66
ee6834b461cb44ed9005958ad1e7957822bb5550,pkiri-codal,backend/rptool/views.py,17,23,6
ee6834b461cb44ed9005958ad1e7957822bb5550,pkiri-codal,docker-compose.yml,89,128,39
ee6834b461cb44ed9005958ad1e7957822bb5550,pkiri-codal,frontend/package-lock.json,183,183,0
ee6834b461cb44ed9005958ad1e7957822bb5550,pkiri-codal,frontend/package.json,4,4,0
ee6834b461cb44ed9005958ad1e7957822bb5550,pkiri-codal,frontend/src/Actions/index.js,219,351,132
ee6834b461cb44ed9005958ad1e7957822bb5550,pkiri-codal,frontend/src/Actions/type.js,4,4,0
ee6834b461cb44ed9005958ad1e7957822bb5550,pkiri-codal,frontend/src/Assets/css/scss/_table.scss,32,33,1
ee6834b461cb44ed9005958ad1e7957822bb5550,pkiri-codal,frontend/src/Assets/css/scss/style.css,21,21,0
ee6834b461cb44ed9005958ad1e7957822bb5550,pkiri-codal,frontend/src/Assets/css/scss/style.css.map,1,2,1
ee6834b461cb44ed9005958ad1e7957822bb5550,pkiri-codal,frontend/src/Pages/Common/Component/Header.jsx,1,2,1
ee6834b461cb44ed9005958ad1e7957822bb5550,pkiri-codal,frontend/src/Pages/People/Component/employee.jsx,176,186,10
ee6834b461cb44ed9005958ad1e7957822bb5550,pkiri-codal,frontend/src/Pages/People/Component/upcoming.jsx,1,2,1
ee6834b461cb44ed9005958ad1e7957822bb5550,pkiri-codal,frontend/src/Pages/People/Container/index.js,6,7,1
ee6834b461cb44ed9005958ad1e7957822bb5550,pkiri-codal,frontend/src/Pages/Projects/AddProject/Component/addProject.jsx,5,15,10
ee6834b461cb44ed9005958ad1e7957822bb5550,pkiri-codal,frontend/src/Pages/Projects/AddProject/Container/index.js,1,2,1
ee6834b461cb44ed9005958ad1e7957822bb5550,pkiri-codal,frontend/src/Pages/Projects/EditProject/Component/EditProject.js,1,2,1
ee6834b461cb44ed9005958ad1e7957822bb5550,pkiri-codal,frontend/src/Pages/Projects/ProjectDetails/Component/project.jsx,31,45,14
ee6834b461cb44ed9005958ad1e7957822bb5550,pkiri-codal,frontend/src/Pages/Projects/ProjectDetails/Container/index.js,4,8,4
ee6834b461cb44ed9005958ad1e7957822bb5550,pkiri-codal,frontend/src/Pages/Request/EditChangeAllocation/Component/EditAllocation.jsx,14,16,2
ee6834b461cb44ed9005958ad1e7957822bb5550,pkiri-codal,frontend/src/Pages/Request/EditMoveAllocation/Component/EditMoveResource.jsx,27,43,16
ee6834b461cb44ed9005958ad1e7957822bb5550,pkiri-codal,frontend/src/Pages/Request/EditRequest/Component/EditResource.jsx,218,806,588
ee6834b461cb44ed9005958ad1e7957822bb5550,pkiri-codal,frontend/src/Pages/Request/EditRequest/Container/index.js,4,5,1
ee6834b461cb44ed9005958ad1e7957822bb5550,pkiri-codal,frontend/src/Pages/Request/RequestList/Component/request.jsx,46,77,31
ee6834b461cb44ed9005958ad1e7957822bb5550,pkiri-codal,frontend/src/Pages/Request/RequestResource/Component/AddRequest/AddRequest.jsx,19,42,23
ee6834b461cb44ed9005958ad1e7957822bb5550,pkiri-codal,frontend/src/Pages/Request/RequestResource/Component/EditResource/Component/EditRequest.jsx,26,55,29
ee6834b461cb44ed9005958ad1e7957822bb5550,pkiri-codal,frontend/src/Pages/Request/RequestResource/Component/MoveResourceStep/Component/MoveResource.jsx,7,19,12
ee6834b461cb44ed9005958ad1e7957822bb5550,pkiri-codal,frontend/src/Pages/Request/RequestResource/Component/MoveResourceStep/Component/Step1.jsx,61,85,24
ee6834b461cb44ed9005958ad1e7957822bb5550,pkiri-codal,frontend/src/Pages/Request/RequestResource/Component/MoveResourceStep/Component/Step2.jsx,67,109,42
ee6834b461cb44ed9005958ad1e7957822bb5550,pkiri-codal,frontend/src/Pages/Request/RequestResource/Component/RequestSubmit.jsx,14,28,14
ee6834b461cb44ed9005958ad1e7957822bb5550,pkiri-codal,frontend/src/Pages/UserProfile/Edit/Component/EditProfile.jsx,1,2,1
ee6834b461cb44ed9005958ad1e7957822bb5550,pkiri-codal,frontend/src/Pages/UserProfile/Profile/Component/profile.jsx,34,52,18
ee6834b461cb44ed9005958ad1e7957822bb5550,pkiri-codal,frontend/src/Pages/UserProfile/Profile/Container/index.js,4,8,4
ee6834b461cb44ed9005958ad1e7957822bb5550,pkiri-codal,frontend/src/Reducers/Employee/ExportEmployee.js,20,20,0
ee6834b461cb44ed9005958ad1e7957822bb5550,pkiri-codal,frontend/src/Reducers/ResourceRequest.js,2,4,2
ee6834b461cb44ed9005958ad1e7957822bb5550,pkiri-codal,frontend/src/Reducers/ResourceUpdate.js,1,2,1
ee6834b461cb44ed9005958ad1e7957822bb5550,pkiri-codal,frontend/src/Reducers/index.js,4,7,3
ee6834b461cb44ed9005958ad1e7957822bb5550,pkiri-codal,frontend/src/common/googleConfig.js,1,2,1
ba48ea4f0acf6c04de4faa05f8004d45cc1ccaa5,codal-sid,frontend/src/Actions/index.js,5,11,6
ba48ea4f0acf6c04de4faa05f8004d45cc1ccaa5,codal-sid,frontend/src/Pages/Projects/ProjectDetails/Component/project.jsx,28,39,11
ba48ea4f0acf6c04de4faa05f8004d45cc1ccaa5,codal-sid,frontend/src/Pages/Request/EditChangeAllocation/Component/EditAllocation.jsx,14,16,2
ba48ea4f0acf6c04de4faa05f8004d45cc1ccaa5,codal-sid,frontend/src/Pages/Request/EditMoveAllocation/Component/EditMoveResource.jsx,27,43,16
ba48ea4f0acf6c04de4faa05f8004d45cc1ccaa5,codal-sid,frontend/src/Pages/Request/EditRequest/Component/EditResource.jsx,22,47,25
ba48ea4f0acf6c04de4faa05f8004d45cc1ccaa5,codal-sid,frontend/src/Pages/Request/RequestList/Component/request.jsx,15,32,17
ba48ea4f0acf6c04de4faa05f8004d45cc1ccaa5,codal-sid,frontend/src/Pages/Request/RequestResource/Component/EditResource/Component/EditRequest.jsx,15,17,2
ba48ea4f0acf6c04de4faa05f8004d45cc1ccaa5,codal-sid,frontend/src/Pages/Request/RequestResource/Component/MoveResourceStep/Component/MoveResource.jsx,2,4,2
ba48ea4f0acf6c04de4faa05f8004d45cc1ccaa5,codal-sid,frontend/src/Pages/Request/RequestResource/Component/MoveResourceStep/Component/Step1.jsx,8,14,6
ba48ea4f0acf6c04de4faa05f8004d45cc1ccaa5,codal-sid,frontend/src/Pages/Request/RequestResource/Component/MoveResourceStep/Component/Step2.jsx,18,22,4
ba48ea4f0acf6c04de4faa05f8004d45cc1ccaa5,codal-sid,frontend/src/Pages/Request/RequestResource/Component/RequestSubmit.jsx,13,22,9
ba48ea4f0acf6c04de4faa05f8004d45cc1ccaa5,codal-sid,frontend/src/Pages/UserProfile/Profile/Component/profile.jsx,25,37,12
ba48ea4f0acf6c04de4faa05f8004d45cc1ccaa5,codal-sid,frontend/src/Pages/UserProfile/Profile/Container/index.js,2,4,2
2f40d13db4a35b0a345301b39b8c284b5212c2a8,codal-jsojitra,frontend/src/Actions/index.js,0,1,1
2f40d13db4a35b0a345301b39b8c284b5212c2a8,codal-jsojitra,frontend/src/Pages/UserProfile/Profile/Component/profile.jsx,6,13,7
20f7c8663647132599214ac6b33b68c1222e7fd4,codal-jsojitra,frontend/src/Pages/Request/EditChangeAllocation/Component/EditAllocation.jsx,14,23,9
20f7c8663647132599214ac6b33b68c1222e7fd4,codal-jsojitra,frontend/src/Pages/Request/EditMoveAllocation/Component/EditMoveResource.jsx,8,11,3
20f7c8663647132599214ac6b33b68c1222e7fd4,codal-jsojitra,frontend/src/Pages/Request/RequestResource/Component/MoveResourceStep/Component/Step1.jsx,2,4,2
20f7c8663647132599214ac6b33b68c1222e7fd4,codal-jsojitra,frontend/src/Pages/Request/RequestResource/Component/MoveResourceStep/Component/Step2.jsx,7,9,2
20f7c8663647132599214ac6b33b68c1222e7fd4,codal-jsojitra,frontend/src/Pages/Request/RequestResource/Component/RequestSubmit.jsx,13,25,12
ed8ef1d9a2e11102689f6ad896f274eb021a5452,codal-sid,backend/docker/config/nginx/conf.d/local.conf,7,100,93
ed8ef1d9a2e11102689f6ad896f274eb021a5452,codal-sid,docker-compose.yml,89,128,39
2719c19ac62482d015c4acc64e5cebef4c571392,codal-sid,backend/docker/config/nginx/conf.d/local.conf,7,100,93
2719c19ac62482d015c4acc64e5cebef4c571392,codal-sid,docker-compose.yml,89,128,39
b577289ea7f6f21c647c49771637f34ec80806b6,codal-jsojitra,frontend/src/Pages/Request/EditRequest/Component/EditResource.jsx,22,47,25
b577289ea7f6f21c647c49771637f34ec80806b6,codal-jsojitra,frontend/src/Pages/Request/RequestList/Component/request.jsx,9,18,9
b577289ea7f6f21c647c49771637f34ec80806b6,codal-jsojitra,frontend/src/Pages/Request/RequestResource/Component/EditResource/Component/EditRequest.jsx,8,10,2
44037db27b721aee9424bda7f6e75b138b91899f,codal-sid,backend/rptool/views.py,2,4,2
efe06313428fd336f53074bee2e5c4a05da7d66d,codal-sid,backend/rptool/views.py,2,4,2
574d3767f31b50d09da0678069f5256d2abe59b0,codal-jsojitra,frontend/src/Actions/index.js,5,10,5
574d3767f31b50d09da0678069f5256d2abe59b0,codal-jsojitra,frontend/src/Pages/Projects/ProjectDetails/Component/project.jsx,28,39,11
574d3767f31b50d09da0678069f5256d2abe59b0,codal-jsojitra,frontend/src/Pages/Request/EditChangeAllocation/Component/EditAllocation.jsx,7,7,0
574d3767f31b50d09da0678069f5256d2abe59b0,codal-jsojitra,frontend/src/Pages/Request/EditMoveAllocation/Component/EditMoveResource.jsx,21,36,15
574d3767f31b50d09da0678069f5256d2abe59b0,codal-jsojitra,frontend/src/Pages/Request/RequestList/Component/request.jsx,6,14,8
574d3767f31b50d09da0678069f5256d2abe59b0,codal-jsojitra,frontend/src/Pages/Request/RequestResource/Component/EditResource/Component/EditRequest.jsx,7,7,0
574d3767f31b50d09da0678069f5256d2abe59b0,codal-jsojitra,frontend/src/Pages/Request/RequestResource/Component/MoveResourceStep/Component/MoveResource.jsx,2,4,2
574d3767f31b50d09da0678069f5256d2abe59b0,codal-jsojitra,frontend/src/Pages/Request/RequestResource/Component/MoveResourceStep/Component/Step1.jsx,6,10,4
574d3767f31b50d09da0678069f5256d2abe59b0,codal-jsojitra,frontend/src/Pages/Request/RequestResource/Component/MoveResourceStep/Component/Step2.jsx,11,13,2
574d3767f31b50d09da0678069f5256d2abe59b0,codal-jsojitra,frontend/src/Pages/Request/RequestResource/Component/RequestSubmit.jsx,4,5,1
574d3767f31b50d09da0678069f5256d2abe59b0,codal-jsojitra,frontend/src/Pages/UserProfile/Profile/Component/profile.jsx,19,24,5
574d3767f31b50d09da0678069f5256d2abe59b0,codal-jsojitra,frontend/src/Pages/UserProfile/Profile/Container/index.js,2,4,2
000062da583d0a0b35346fcaab123b7d16aed39d,codal-sid,backend/rptool/serializers.py,1,2,1
cfc4c27088204d9a818e5cc69cc509b476877783,codal-sid,frontend/src/common/Config.js,1,3,2
0ea9501eff83bc7e6a3e73520709049fc7473292,codal-sid,frontend/src/common/Config.js,1,1,0
6621b0b92d866b41ad4179c5ad7797e9ffd4198b,codal-sid,frontend/src/common/Config.js,1,2,1
6acea098d305c585be396e646a4e3a0a20ed7084,codal-sid,backend/rptool/serializers.py,1,2,1
6acea098d305c585be396e646a4e3a0a20ed7084,codal-sid,frontend/src/common/Config.js,2,4,2
790bb34386ee4c9d5fbd4985ffe673059f4ba75a,codal-sid,frontend/package-lock.json,8,8,0
790bb34386ee4c9d5fbd4985ffe673059f4ba75a,codal-sid,frontend/package.json,1,1,0
790bb34386ee4c9d5fbd4985ffe673059f4ba75a,codal-sid,frontend/src/Pages/People/Component/employee.jsx,82,144,62
fe23c94de3bcd552f969b57ce16f77f78d8dc2ed,codal-jsojitra,frontend/package-lock.json,8,8,0
fe23c94de3bcd552f969b57ce16f77f78d8dc2ed,codal-jsojitra,frontend/package.json,1,1,0
fe23c94de3bcd552f969b57ce16f77f78d8dc2ed,codal-jsojitra,frontend/src/Pages/People/Component/employee.jsx,82,144,62
adfdf4c6b49088988499bdcadca4c83b85840626,codal-sid,frontend/package-lock.json,170,170,0
adfdf4c6b49088988499bdcadca4c83b85840626,codal-sid,frontend/package.json,2,2,0
adfdf4c6b49088988499bdcadca4c83b85840626,codal-sid,frontend/src/Assets/css/scss/_table.scss,32,33,1
adfdf4c6b49088988499bdcadca4c83b85840626,codal-sid,frontend/src/Assets/css/scss/style.css,21,21,0
adfdf4c6b49088988499bdcadca4c83b85840626,codal-sid,frontend/src/Assets/css/scss/style.css.map,1,2,1
adfdf4c6b49088988499bdcadca4c83b85840626,codal-sid,frontend/src/Pages/People/Component/employee.jsx,86,96,10
adfdf4c6b49088988499bdcadca4c83b85840626,codal-sid,frontend/src/Pages/Projects/ProjectDetails/Component/project.jsx,1,2,1
47313efc4b9313305d0f6e53c0114b6a39164a13,codal-jsojitra,frontend/src/Pages/People/Component/employee.jsx,0,12,12
d5c9d6bdcbbb555802d9f4e46b72a87b9d283b4f,codal-jsojitra,frontend/src/Pages/People/Component/PDF.jsx,0,30,30
44bf1a291265d488a3613602f2a55511948cd770,codal-jsojitra,frontend/src/Pages/Projects/ProjectDetails/Component/project.jsx,1,2,1
1a379f4787f37a2066789058733d016bde48a897,codal-jsojitra,frontend/package-lock.json,170,170,0
1a379f4787f37a2066789058733d016bde48a897,codal-jsojitra,frontend/package.json,2,2,0
1a379f4787f37a2066789058733d016bde48a897,codal-jsojitra,frontend/src/Assets/css/scss/_table.scss,32,33,1
1a379f4787f37a2066789058733d016bde48a897,codal-jsojitra,frontend/src/Assets/css/scss/style.css,21,21,0
1a379f4787f37a2066789058733d016bde48a897,codal-jsojitra,frontend/src/Assets/css/scss/style.css.map,1,2,1
1a379f4787f37a2066789058733d016bde48a897,codal-jsojitra,frontend/src/Pages/People/Component/PDF.jsx,30,30,0
1a379f4787f37a2066789058733d016bde48a897,codal-jsojitra,frontend/src/Pages/People/Component/employee.jsx,98,108,10
239157ade0a37731c26e7ee6c1bd18be5754cccd,codal-sid,frontend/package-lock.json,5,5,0
239157ade0a37731c26e7ee6c1bd18be5754cccd,codal-sid,frontend/package.json,1,1,0
239157ade0a37731c26e7ee6c1bd18be5754cccd,codal-sid,frontend/src/Actions/index.js,3,6,3
239157ade0a37731c26e7ee6c1bd18be5754cccd,codal-sid,frontend/src/Pages/Common/Component/Header.jsx,1,2,1
239157ade0a37731c26e7ee6c1bd18be5754cccd,codal-sid,frontend/src/Pages/People/Component/employee.jsx,52,62,10
239157ade0a37731c26e7ee6c1bd18be5754cccd,codal-sid,frontend/src/Pages/Projects/AddProject/Component/addProject.jsx,1,3,2
239157ade0a37731c26e7ee6c1bd18be5754cccd,codal-sid,frontend/src/Pages/Projects/AddProject/Container/index.js,1,2,1
239157ade0a37731c26e7ee6c1bd18be5754cccd,codal-sid,frontend/src/Pages/Projects/EditProject/Component/EditProject.js,1,2,1
239157ade0a37731c26e7ee6c1bd18be5754cccd,codal-sid,frontend/src/Pages/Request/EditRequest/Component/EditResource.jsx,1,2,1
239157ade0a37731c26e7ee6c1bd18be5754cccd,codal-sid,frontend/src/Pages/Request/RequestList/Component/request.jsx,0,2,2
239157ade0a37731c26e7ee6c1bd18be5754cccd,codal-sid,frontend/src/Pages/Request/RequestResource/Component/AddRequest/AddRequest.jsx,1,2,1
239157ade0a37731c26e7ee6c1bd18be5754cccd,codal-sid,frontend/src/Pages/Request/RequestResource/Component/MoveResourceStep/Component/MoveResource.jsx,1,4,3
239157ade0a37731c26e7ee6c1bd18be5754cccd,codal-sid,frontend/src/Pages/Request/RequestResource/Component/MoveResourceStep/Component/Step2.jsx,46,82,36
239157ade0a37731c26e7ee6c1bd18be5754cccd,codal-sid,frontend/src/Pages/UserProfile/Edit/Component/EditProfile.jsx,1,2,1
239157ade0a37731c26e7ee6c1bd18be5754cccd,codal-sid,frontend/src/Reducers/Employee/ExportEmployee.js,1,2,1
a55687a2bb7ad26e3cf475850758d022a080d1da,codal-jsojitra,frontend/src/Pages/People/Component/employee.jsx,3,6,3
f99a9e425f0fe0f7336342b8957ca737d64cfc28,codal-jsojitra,frontend/package-lock.json,5,5,0
f99a9e425f0fe0f7336342b8957ca737d64cfc28,codal-jsojitra,frontend/package.json,1,1,0
f99a9e425f0fe0f7336342b8957ca737d64cfc28,codal-jsojitra,frontend/src/Pages/People/Component/employee.jsx,52,62,10
f99a9e425f0fe0f7336342b8957ca737d64cfc28,codal-jsojitra,frontend/src/Reducers/Employee/ExportEmployee.js,1,2,1
f99a9e425f0fe0f7336342b8957ca737d64cfc28,codal-jsojitra,frontend/src/common/PrivateRoute.js,14,14,0
f99a9e425f0fe0f7336342b8957ca737d64cfc28,codal-jsojitra,frontend/src/common/storageService.js,22,22,0
d4910858eb8f43d2c6bdf17322bc9ca3a1236a93,codal-jsojitra,frontend/src/Pages/Request/RequestResource/Component/MoveResourceStep/Component/MoveResource.jsx,1,2,1
d4910858eb8f43d2c6bdf17322bc9ca3a1236a93,codal-jsojitra,frontend/src/Pages/Request/RequestResource/Component/MoveResourceStep/Component/Step2.jsx,46,82,36
508982173d5fed1b33177b2e1e862dd4253c80e5,codal-jsojitra,frontend/src/Actions/index.js,3,6,3
508982173d5fed1b33177b2e1e862dd4253c80e5,codal-jsojitra,frontend/src/Pages/Common/Component/Header.jsx,1,2,1
508982173d5fed1b33177b2e1e862dd4253c80e5,codal-jsojitra,frontend/src/Pages/Projects/AddProject/Component/addProject.jsx,1,3,2
508982173d5fed1b33177b2e1e862dd4253c80e5,codal-jsojitra,frontend/src/Pages/Projects/AddProject/Container/index.js,1,2,1
508982173d5fed1b33177b2e1e862dd4253c80e5,codal-jsojitra,frontend/src/Pages/Projects/EditProject/Component/EditProject.js,1,2,1
508982173d5fed1b33177b2e1e862dd4253c80e5,codal-jsojitra,frontend/src/Pages/Request/EditRequest/Component/EditResource.jsx,1,2,1
508982173d5fed1b33177b2e1e862dd4253c80e5,codal-jsojitra,frontend/src/Pages/Request/RequestList/Component/request.jsx,0,2,2
508982173d5fed1b33177b2e1e862dd4253c80e5,codal-jsojitra,frontend/src/Pages/Request/RequestResource/Component/AddRequest/AddRequest.jsx,1,2,1
508982173d5fed1b33177b2e1e862dd4253c80e5,codal-jsojitra,frontend/src/Pages/Request/RequestResource/Component/MoveResourceStep/Component/MoveResource.jsx,0,2,2
508982173d5fed1b33177b2e1e862dd4253c80e5,codal-jsojitra,frontend/src/Pages/UserProfile/Edit/Component/EditProfile.jsx,1,2,1
508982173d5fed1b33177b2e1e862dd4253c80e5,codal-jsojitra,frontend/src/common/PrivateRoute.js,0,14,14
508982173d5fed1b33177b2e1e862dd4253c80e5,codal-jsojitra,frontend/src/common/storageService.js,0,22,22
10ea6bd69bd48c9421558be575f218bd33107857,codal-sid,frontend/src/Actions/index.js,33,34,1
10ea6bd69bd48c9421558be575f218bd33107857,codal-sid,frontend/src/Actions/type.js,4,4,0
10ea6bd69bd48c9421558be575f218bd33107857,codal-sid,frontend/src/Pages/People/Component/employee.jsx,23,28,5
10ea6bd69bd48c9421558be575f218bd33107857,codal-sid,frontend/src/Pages/People/Container/index.js,6,7,1
10ea6bd69bd48c9421558be575f218bd33107857,codal-sid,frontend/src/Pages/Projects/AddProject/Component/addProject.jsx,4,12,8
10ea6bd69bd48c9421558be575f218bd33107857,codal-sid,frontend/src/Pages/Projects/ProjectDetails/Component/project.jsx,2,4,2
10ea6bd69bd48c9421558be575f218bd33107857,codal-sid,frontend/src/Pages/Request/RequestResource/Component/EditResource/Component/EditRequest.jsx,9,31,22
10ea6bd69bd48c9421558be575f218bd33107857,codal-sid,frontend/src/Reducers/Employee/ExportEmployee.js,20,20,0
10ea6bd69bd48c9421558be575f218bd33107857,codal-sid,frontend/src/Reducers/index.js,4,7,3
c02b6370e422ae96b592aeac12923437a084a9db,codal-jsojitra,frontend/src/Actions/index.js,33,34,1
c02b6370e422ae96b592aeac12923437a084a9db,codal-jsojitra,frontend/src/Actions/type.js,4,4,0
c02b6370e422ae96b592aeac12923437a084a9db,codal-jsojitra,frontend/src/Pages/People/Component/employee.jsx,23,28,5
c02b6370e422ae96b592aeac12923437a084a9db,codal-jsojitra,frontend/src/Pages/People/Container/index.js,6,7,1
c02b6370e422ae96b592aeac12923437a084a9db,codal-jsojitra,frontend/src/Pages/Projects/AddProject/Component/addProject.jsx,4,12,8
c02b6370e422ae96b592aeac12923437a084a9db,codal-jsojitra,frontend/src/Pages/Projects/ProjectDetails/Component/project.jsx,2,4,2
c02b6370e422ae96b592aeac12923437a084a9db,codal-jsojitra,frontend/src/Pages/Request/RequestResource/Component/EditResource/Component/EditRequest.jsx,9,31,22
c02b6370e422ae96b592aeac12923437a084a9db,codal-jsojitra,frontend/src/Reducers/Employee/ExportEmployee.js,20,20,0
c02b6370e422ae96b592aeac12923437a084a9db,codal-jsojitra,frontend/src/Reducers/index.js,4,7,3
65db7aa16ce22152effbb6406b588b22fe500cbd,codal-sid,frontend/src/Actions/index.js,4,8,4
65db7aa16ce22152effbb6406b588b22fe500cbd,codal-sid,frontend/src/Pages/People/Component/employee.jsx,1,2,1
65db7aa16ce22152effbb6406b588b22fe500cbd,codal-sid,frontend/src/Pages/Projects/ProjectDetails/Component/project.jsx,3,6,3
65db7aa16ce22152effbb6406b588b22fe500cbd,codal-sid,frontend/src/Pages/Projects/ProjectDetails/Container/index.js,4,8,4
65db7aa16ce22152effbb6406b588b22fe500cbd,codal-sid,frontend/src/Pages/Request/EditRequest/Component/EditResource.jsx,16,133,117
65db7aa16ce22152effbb6406b588b22fe500cbd,codal-sid,frontend/src/Pages/Request/EditRequest/Container/index.js,4,5,1
65db7aa16ce22152effbb6406b588b22fe500cbd,codal-sid,frontend/src/Pages/UserProfile/Profile/Component/profile.jsx,1,2,1
65db7aa16ce22152effbb6406b588b22fe500cbd,codal-sid,frontend/src/Pages/UserProfile/Profile/Container/index.js,2,4,2
65db7aa16ce22152effbb6406b588b22fe500cbd,codal-sid,frontend/src/Reducers/ResourceUpdate.js,1,2,1
01189f7fc4dbcb14b81251cdd83d43d1b0f51e3e,codal-sid,backend/rptool/serializers.py,11,18,7
01189f7fc4dbcb14b81251cdd83d43d1b0f51e3e,codal-sid,backend/rptool/signals.py,9,16,7
dd22dddc4173fd8ba3edf6f7075a886a0786ecf3,codal-sid,backend/rptool/serializers.py,11,18,7
dd22dddc4173fd8ba3edf6f7075a886a0786ecf3,codal-sid,backend/rptool/signals.py,9,16,7
25ba01c5839ddd480be83cf49c5f76d201b1c565,codal-jsojitra,frontend/src/Pages/People/Component/employee.jsx,1,2,1
f4364cb7ef23fe3b812ddb30f30e8facbadcad1c,codal-jsojitra,frontend/src/Actions/index.js,4,8,4
f4364cb7ef23fe3b812ddb30f30e8facbadcad1c,codal-jsojitra,frontend/src/Pages/Projects/ProjectDetails/Component/project.jsx,3,6,3
f4364cb7ef23fe3b812ddb30f30e8facbadcad1c,codal-jsojitra,frontend/src/Pages/Projects/ProjectDetails/Container/index.js,4,8,4
f4364cb7ef23fe3b812ddb30f30e8facbadcad1c,codal-jsojitra,frontend/src/Pages/Request/EditRequest/Component/EditResource.jsx,16,133,117
f4364cb7ef23fe3b812ddb30f30e8facbadcad1c,codal-jsojitra,frontend/src/Pages/Request/EditRequest/Container/index.js,4,5,1
f4364cb7ef23fe3b812ddb30f30e8facbadcad1c,codal-jsojitra,frontend/src/Pages/UserProfile/Profile/Component/profile.jsx,1,2,1
f4364cb7ef23fe3b812ddb30f30e8facbadcad1c,codal-jsojitra,frontend/src/Pages/UserProfile/Profile/Container/index.js,2,4,2
f4364cb7ef23fe3b812ddb30f30e8facbadcad1c,codal-jsojitra,frontend/src/Reducers/ResourceUpdate.js,1,2,1
30d3c5d6b578d18e78839d023ebcf5033c049f7b,codal-sid,backend/rptool/views.py,6,6,0
1962a2e80d42e16648d6ec1c46acace15230f033,codal-sid,backend/rptool/views.py,6,6,0
e8988957d91e917c166e27854c2c25d2dad2e24d,codal-sid,backend/rptool/serializers.py,4,6,2
e8988957d91e917c166e27854c2c25d2dad2e24d,codal-sid,backend/rptool/views.py,6,7,1
e6e5b53fa08a64a6c76a2d32299c84fa9061b19d,codal-sid,backend/rptool/serializers.py,4,6,2
e6e5b53fa08a64a6c76a2d32299c84fa9061b19d,codal-sid,backend/rptool/views.py,6,7,1
14708aa8efc0adcbb03c1ed30ef05b95fe84a7dd,codal-sid,frontend/src/Pages/People/Component/employee.jsx,4,7,3
14708aa8efc0adcbb03c1ed30ef05b95fe84a7dd,codal-sid,frontend/src/Pages/People/Component/upcoming.jsx,1,2,1
14708aa8efc0adcbb03c1ed30ef05b95fe84a7dd,codal-sid,frontend/src/Pages/Request/EditRequest/Component/EditResource.jsx,195,671,476
14708aa8efc0adcbb03c1ed30ef05b95fe84a7dd,codal-sid,frontend/src/Pages/Request/RequestList/Component/request.jsx,7,9,2
14708aa8efc0adcbb03c1ed30ef05b95fe84a7dd,codal-sid,frontend/src/Pages/Request/RequestResource/Component/AddRequest/AddRequest.jsx,18,40,22
14708aa8efc0adcbb03c1ed30ef05b95fe84a7dd,codal-sid,frontend/src/Pages/Request/RequestResource/Component/EditResource/Component/EditRequest.jsx,4,11,7
14708aa8efc0adcbb03c1ed30ef05b95fe84a7dd,codal-sid,frontend/src/Pages/Request/RequestResource/Component/MoveResourceStep/Component/MoveResource.jsx,5,13,8
14708aa8efc0adcbb03c1ed30ef05b95fe84a7dd,codal-sid,frontend/src/Pages/Request/RequestResource/Component/MoveResourceStep/Component/Step1.jsx,58,81,23
14708aa8efc0adcbb03c1ed30ef05b95fe84a7dd,codal-sid,frontend/src/Pages/Request/RequestResource/Component/MoveResourceStep/Component/Step2.jsx,5,9,4
14708aa8efc0adcbb03c1ed30ef05b95fe84a7dd,codal-sid,frontend/src/Pages/Request/RequestResource/Component/RequestSubmit.jsx,2,8,6
14708aa8efc0adcbb03c1ed30ef05b95fe84a7dd,codal-sid,frontend/src/Reducers/ResourceRequest.js,2,4,2
a3322ba5bb936a7ce728dea777a83dceb945f67b,codal-jsojitra,frontend/src/Pages/People/Component/employee.jsx,2,3,1
a3322ba5bb936a7ce728dea777a83dceb945f67b,codal-jsojitra,frontend/src/Pages/Request/EditRequest/Component/EditResource.jsx,195,671,476
96921b3e693b179b108420c7d9f19ba06f59e09a,codal-jsojitra,frontend/src/Pages/People/Component/employee.jsx,2,4,2
96921b3e693b179b108420c7d9f19ba06f59e09a,codal-jsojitra,frontend/src/Pages/People/Component/upcoming.jsx,1,2,1
96921b3e693b179b108420c7d9f19ba06f59e09a,codal-jsojitra,frontend/src/Pages/Request/RequestList/Component/request.jsx,7,9,2
96921b3e693b179b108420c7d9f19ba06f59e09a,codal-jsojitra,frontend/src/Pages/Request/RequestResource/Component/AddRequest/AddRequest.jsx,18,40,22
96921b3e693b179b108420c7d9f19ba06f59e09a,codal-jsojitra,frontend/src/Pages/Request/RequestResource/Component/MoveResourceStep/Component/MoveResource.jsx,2,4,2
96921b3e693b179b108420c7d9f19ba06f59e09a,codal-jsojitra,frontend/src/Pages/Request/RequestResource/Component/MoveResourceStep/Component/Step1.jsx,4,7,3
96921b3e693b179b108420c7d9f19ba06f59e09a,codal-jsojitra,frontend/src/Pages/Request/RequestResource/Component/MoveResourceStep/Component/Step2.jsx,5,9,4
96921b3e693b179b108420c7d9f19ba06f59e09a,codal-jsojitra,frontend/src/Reducers/ResourceRequest.js,2,4,2
c590f1a2c43a286f2ccdbef0895e4a17f443b557,codal-sid,backend/rptool/migrations/0028_employee_is_future_employee.py,18,18,0
c590f1a2c43a286f2ccdbef0895e4a17f443b557,codal-sid,backend/rptool/models.py,2,3,1
c590f1a2c43a286f2ccdbef0895e4a17f443b557,codal-sid,backend/rptool/serializers.py,13,15,2
c590f1a2c43a286f2ccdbef0895e4a17f443b557,codal-sid,backend/rptool/signals.py,21,33,12
c590f1a2c43a286f2ccdbef0895e4a17f443b557,codal-sid,backend/rptool/views.py,3,6,3
a5d98851a18bce28c78a59ec77cce781d21b5296,codal-sid,backend/rptool/migrations/0028_employee_is_future_employee.py,18,18,0
a5d98851a18bce28c78a59ec77cce781d21b5296,codal-sid,backend/rptool/models.py,2,3,1
a5d98851a18bce28c78a59ec77cce781d21b5296,codal-sid,backend/rptool/serializers.py,13,15,2
a5d98851a18bce28c78a59ec77cce781d21b5296,codal-sid,backend/rptool/signals.py,21,33,12
a5d98851a18bce28c78a59ec77cce781d21b5296,codal-sid,backend/rptool/views.py,3,6,3
734b0e084abc5a6b1b6d26132c5100e54ebe526d,codal-jsojitra,frontend/src/Pages/Request/RequestResource/Component/MoveResourceStep/Component/MoveResource.jsx,3,9,6
734b0e084abc5a6b1b6d26132c5100e54ebe526d,codal-jsojitra,frontend/src/Pages/Request/RequestResource/Component/MoveResourceStep/Component/Step1.jsx,13,21,8
d6e57137b8acf73dfbe979a9b9870e04689e7404,codal-jsojitra,frontend/src/Pages/Request/RequestResource/Component/EditResource/Component/EditRequest.jsx,4,11,7
d6e57137b8acf73dfbe979a9b9870e04689e7404,codal-jsojitra,frontend/src/Pages/Request/RequestResource/Component/MoveResourceStep/Component/Step1.jsx,47,65,18
d6e57137b8acf73dfbe979a9b9870e04689e7404,codal-jsojitra,frontend/src/Pages/Request/RequestResource/Component/RequestSubmit.jsx,2,8,6
c7025f4e12a2f751a7f74db4958e264ba9d985ff,codal-sid,frontend/src/Actions/index.js,19,38,19
c7025f4e12a2f751a7f74db4958e264ba9d985ff,codal-sid,frontend/src/Pages/People/Component/employee.jsx,11,13,2
c7025f4e12a2f751a7f74db4958e264ba9d985ff,codal-sid,frontend/src/Pages/Request/EditRequest/Component/EditResource.jsx,17,19,2
c7025f4e12a2f751a7f74db4958e264ba9d985ff,codal-sid,frontend/src/Pages/Request/RequestList/Component/request.jsx,8,9,1
c7025f4e12a2f751a7f74db4958e264ba9d985ff,codal-sid,frontend/src/Pages/UserProfile/Profile/Component/profile.jsx,8,13,5
c7025f4e12a2f751a7f74db4958e264ba9d985ff,codal-sid,frontend/src/common/googleConfig.js,1,2,1
506c1992ba6210f9926b16f8bcc1669d6ce94ca6,codal-jsojitra,frontend/src/Pages/People/Component/employee.jsx,11,13,2
506c1992ba6210f9926b16f8bcc1669d6ce94ca6,codal-jsojitra,frontend/src/Pages/Request/RequestList/Component/request.jsx,1,2,1
7aebc60d2fe847ebee8b477c04460b7e05b5d395,codal-jsojitra,frontend/src/Actions/index.js,1,2,1
7aebc60d2fe847ebee8b477c04460b7e05b5d395,codal-jsojitra,frontend/src/Pages/UserProfile/Profile/Component/profile.jsx,6,9,3
56ab41b684fb43c753d9f28b091d016c802589e1,codal-jsojitra,frontend/src/Actions/index.js,18,36,18
56ab41b684fb43c753d9f28b091d016c802589e1,codal-jsojitra,frontend/src/Pages/Request/EditRequest/Component/EditResource.jsx,17,19,2
56ab41b684fb43c753d9f28b091d016c802589e1,codal-jsojitra,frontend/src/Pages/Request/RequestList/Component/request.jsx,8,9,1
56ab41b684fb43c753d9f28b091d016c802589e1,codal-jsojitra,frontend/src/Pages/UserProfile/Profile/Component/profile.jsx,2,4,2
56ab41b684fb43c753d9f28b091d016c802589e1,codal-jsojitra,frontend/src/common/googleConfig.js,1,2,1
cb056f7ad8759416ab6942092d425f9259ba4828,codal-sid,frontend/src/Actions/index.js,176,296,120
cb056f7ad8759416ab6942092d425f9259ba4828,codal-sid,frontend/src/Pages/Projects/ProjectDetails/Component/project.jsx,1,2,1
cb056f7ad8759416ab6942092d425f9259ba4828,codal-sid,frontend/src/Pages/Request/EditMoveAllocation/Component/EditMoveResource.jsx,1,2,1
cb056f7ad8759416ab6942092d425f9259ba4828,codal-sid,frontend/src/Pages/Request/RequestList/Component/request.jsx,17,27,10
cb056f7ad8759416ab6942092d425f9259ba4828,codal-sid,frontend/src/Reducers/ResourceUpdate.js,1,2,1
69db8faa1864ec1ef9754569504dbc35bca5287d,codal-jsojitra,frontend/src/Actions/index.js,176,296,120
69db8faa1864ec1ef9754569504dbc35bca5287d,codal-jsojitra,frontend/src/Pages/Request/RequestList/Component/request.jsx,1,2,1
7e8cbe0dc2d5405e554e0d75e57133b1ee19b73d,codal-sid,backend/rptool/serializers.py,13,18,5
7e8cbe0dc2d5405e554e0d75e57133b1ee19b73d,codal-sid,backend/rptool/signals.py,39,90,51
5fb8d3a9fcd24067db60e5ac809520f17dabe13f,codal-sid,backend/rptool/serializers.py,13,18,5
5fb8d3a9fcd24067db60e5ac809520f17dabe13f,codal-sid,backend/rptool/signals.py,39,90,51
04b5cf29e54b8e92f0120fc918107b8fb0464a32,pkiri-codal,backend/rptool/signals.py,73,146,73
04b5cf29e54b8e92f0120fc918107b8fb0464a32,pkiri-codal,frontend/src/Pages/Request/EditRequest/Component/EditResource.jsx,9,17,8
04b5cf29e54b8e92f0120fc918107b8fb0464a32,pkiri-codal,frontend/src/Pages/Request/RequestResource/Component/EditResource/Component/EditRequest.jsx,11,32,21
5b87e57d0db9b89d53cd61828f1939bf4f3d00a9,codal-jsojitra,frontend/src/Pages/Projects/ProjectDetails/Component/project.jsx,1,2,1
5b87e57d0db9b89d53cd61828f1939bf4f3d00a9,codal-jsojitra,frontend/src/Pages/Request/EditMoveAllocation/Component/EditMoveResource.jsx,1,2,1
5b87e57d0db9b89d53cd61828f1939bf4f3d00a9,codal-jsojitra,frontend/src/Pages/Request/RequestList/Component/request.jsx,16,25,9
5b87e57d0db9b89d53cd61828f1939bf4f3d00a9,codal-jsojitra,frontend/src/Reducers/ResourceUpdate.js,1,2,1
026b94f65c5ebed58984506c46b19734c2798f2a,codal-sid,frontend/src/Pages/Request/EditRequest/Component/EditResource.jsx,9,17,8
026b94f65c5ebed58984506c46b19734c2798f2a,codal-sid,frontend/src/Pages/Request/RequestResource/Component/EditResource/Component/EditRequest.jsx,11,32,21
4fbdd3bbe010d147afbc983b8fda7827dbc511da,codal-sid,backend/rptool/signals.py,73,146,73
f676b25c55f10d3a86b2f69a09b1434c1c05b042,pkiri-codal,backend/rptool/migrations/0027_auto_20200327_1049.py,23,23,0
f676b25c55f10d3a86b2f69a09b1434c1c05b042,pkiri-codal,backend/rptool/models.py,2,3,1
f676b25c55f10d3a86b2f69a09b1434c1c05b042,pkiri-codal,backend/rptool/serializers.py,4,8,4
f676b25c55f10d3a86b2f69a09b1434c1c05b042,pkiri-codal,backend/rptool/signals.py,176,257,81
f676b25c55f10d3a86b2f69a09b1434c1c05b042,pkiri-codal,frontend/src/Assets/css/scss/_component.scss,7,8,1
f676b25c55f10d3a86b2f69a09b1434c1c05b042,pkiri-codal,frontend/src/Assets/css/scss/style.css,4,4,0
f676b25c55f10d3a86b2f69a09b1434c1c05b042,pkiri-codal,frontend/src/Assets/css/scss/style.css.map,1,2,1
f676b25c55f10d3a86b2f69a09b1434c1c05b042,pkiri-codal,frontend/src/Pages/Auth/Component/login.jsx,1,2,1
f676b25c55f10d3a86b2f69a09b1434c1c05b042,pkiri-codal,frontend/src/Pages/People/Component/employee.jsx,1,2,1
f676b25c55f10d3a86b2f69a09b1434c1c05b042,pkiri-codal,frontend/src/Pages/People/Component/people.jsx,1,2,1
f676b25c55f10d3a86b2f69a09b1434c1c05b042,pkiri-codal,frontend/src/Pages/Projects/ProjectDetails/Component/project.jsx,1,2,1
f676b25c55f10d3a86b2f69a09b1434c1c05b042,pkiri-codal,frontend/src/Pages/Projects/ProjectList/Component/projectList.jsx,2,4,2
f676b25c55f10d3a86b2f69a09b1434c1c05b042,pkiri-codal,frontend/src/Pages/Request/EditChangeAllocation/Component/EditAllocation.jsx,23,44,21
f676b25c55f10d3a86b2f69a09b1434c1c05b042,pkiri-codal,frontend/src/Pages/Request/EditMoveAllocation/Component/EditMoveResource.jsx,25,46,21
f676b25c55f10d3a86b2f69a09b1434c1c05b042,pkiri-codal,frontend/src/Pages/Request/RequestList/Component/request.jsx,40,56,16
f676b25c55f10d3a86b2f69a09b1434c1c05b042,pkiri-codal,frontend/src/Pages/Request/RequestResource/Component/AddRequest/AddRequest.jsx,2,2,0
f676b25c55f10d3a86b2f69a09b1434c1c05b042,pkiri-codal,frontend/src/Pages/Request/RequestResource/Component/EditResource/Component/EditRequest.jsx,50,92,42
f676b25c55f10d3a86b2f69a09b1434c1c05b042,pkiri-codal,frontend/src/Pages/Request/RequestResource/Component/MoveResourceStep/Component/MoveResource.jsx,4,7,3
f676b25c55f10d3a86b2f69a09b1434c1c05b042,pkiri-codal,frontend/src/Pages/Request/RequestResource/Component/MoveResourceStep/Component/Step1.jsx,3,5,2
f676b25c55f10d3a86b2f69a09b1434c1c05b042,pkiri-codal,frontend/src/Pages/Request/RequestResource/Component/MoveResourceStep/Component/Step2.jsx,22,32,10
f676b25c55f10d3a86b2f69a09b1434c1c05b042,pkiri-codal,frontend/src/Pages/Request/RequestResource/Component/RequestSubmit.jsx,4,7,3
f676b25c55f10d3a86b2f69a09b1434c1c05b042,pkiri-codal,frontend/src/Pages/Request/RequestResource/Container/index.js,3,3,0
